,id,date,username,text,retweets,likes,replies,total_engagement
109,1741390990299037757,2023-12-31 09:29:00,NemesisNemesi75,"""Sors tes gosses, j’ai mis le feu à l’appart"" hurla Abdallah Chorfi , 36 ans à son voisin. 

Le 24 décembre dernier à Nice, sa compagne, qui travaille de nuit, ne répondait pas à ses appels et à ses SMS. Ivre et jaloux, il alluma un incendie pour se venger. 

Dans cette affaire…",866,1542,74,2482
110,1741122925770522816,2023-12-30 15:43:48,NemesisNemesi75,"Nous avions déjà parlé de cette affaire il y a deux jours mais son nom et sa photo viennent de sortir :

Déjà condamné à deux reprises pour des crimes sexuels, Fabrice G. a été placé en détention provisoire la semaine dernière. Il est suspecté d’avoir enlevé, séquestré et abusé… https://twitter.com/NemesisNemesi75/status/1741122925770522816/photo/1",286,632,37,955
111,1741107303670051202,2023-12-30 14:41:44,NemesisNemesi75,"Malgré les efforts d’un juge pour qu’il puisse rester sur le territoire, un Camerounais en situation irrégulière condamné à de multiples reprises va enfin pouvoir être expulsé du territoire.

Il avait notamment menacé de « violer des jeunes femmes » à l’accueil de la préfecture…",383,974,28,1385
112,1740735779163590777,2023-12-29 14:05:25,NemesisNemesi75,"Un Algérien agresse sexuellement une jeune femme dans un ferry entre Bastia et Toulon alors qu’elle dormait.

https://www.varmatin.com/faits-divers/une-jeune-femme-victime-d-une-agression-sexuelle-a-bord-d-un-ferry-894084",226,375,17,618
113,1740686222886932493,2023-12-29 10:48:30,NemesisNemesi75,"« Tant qu’elle n’est pas morte, je ne serai pas tranquille » 

Ce sont les mots d’un certain Alvin A., un harceleur qui a appelé son ex près de 14 000 fois en 3 mois.

Le prévenu âgé de 30 ans a été condamné à 18 mois de prison dont 12 assortis d’un sursis.…",181,406,29,616
114,1740660434816893400,2023-12-29 09:06:02,NemesisNemesi75,"Une femme victime de viol et dont la plainte pour viol déposée en 2018 à Paris a abouti deux fois à un abandon des poursuites, veut faire reconnaître la responsabilité de l'Etat pour « le préjudice » subi « du fait du traitement judiciaire » de sa procédure.

Selon les avocates,…",498,1079,25,1602
115,1740427095149269308,2023-12-28 17:38:49,NemesisNemesi75,« On peut contacter les psychologues de la police et des unités médico-judiciaires mais il n’y a que 3 psychologues dans tout Paris. Et il y a tellement d’agressions et de viols aujourd’hui qu’elles sont débordées (…) Je suis obligée de prendre mon psychiatre et mon psychologue… https://twitter.com/NemesisNemesi75/status/1740427095149269308/video/1,871,1783,54,2708
116,1740427023359607171,2023-12-28 17:38:32,NemesisNemesi75,@MRLTine pas celle du psychologue,0,7,0,7
117,1740345322109563247,2023-12-28 12:13:53,NemesisNemesi75,"Saône et Loire : Un prédateur sexuel, déjà condamné deux fois, enlève une jeune ado, à Blanzy, la séquestre, et la viole au Creusot.

https://www.creusot-infos.com/news/faits-divers/en-saone-et-loire/saone-et-loire-un-predateur-sexuel-deja-condamne-a-dijon-enleve-une-jeune-ado-a-blanzy-la-sequestre-et-la-viole-au-creusot.html",286,385,14,685
118,1740100449477534125,2023-12-27 20:00:51,NemesisNemesi75,"Dans cet extrait, Claire lance un appel aux médias et aux associations féministes de gauche, notamment @osezlefeminisme. 

➡️Retrouvez son interview en intégralité sur notre chaîne Youtube :

https://youtu.be/JuJpaKTB5Oo?si=nviL_Nw7wboFqXUH https://twitter.com/NemesisNemesi75/status/1740100449477534125/video/1",760,1676,43,2479
119,1739961878908985354,2023-12-27 10:50:13,NemesisNemesi75,"Claire, violée le 11 novembre par un Centrafricain sous OQTF, a eu la gentillesse et le courage de nous confier son témoignage.

Quels sont ses projets ? Comment se reconstruire après une agression ? 

➡️Retrouvez son interview sur notre Youtube ce soir à 21h:… https://twitter.com/NemesisNemesi75/status/1739961878908985354/photo/1",961,2559,45,3565
120,1739955007766622323,2023-12-27 10:22:55,NemesisNemesi75,"Hier soir sur @CNEWS , @CordierAlice2 est revenue sur deux éléments essentiels qui auraient pu éviter la mort d’une femme et de ses quatre enfants:

- l’état de la psychiatrie en France avec un suivi complètement défaillant.

-le manque de moyens concernant la protection des… https://twitter.com/NemesisNemesi75/status/1739955007766622323/video/1",268,591,19,878
121,1739628571503550814,2023-12-26 12:45:46,NemesisNemesi75,"Une mère et ses quatre enfants tués à Meaux lundi 25 décembre : le père a été interpellé à Sevran.

Noé B., le père de famille soupçonné d'avoir tué sa compagne de 35 ans et ses quatre enfants de 10, 7, 4 ans et de 9 mois, à l'arme blanche. Il a été interpellé au domicile de son…",269,733,54,1056
122,1739623761828061281,2023-12-26 12:26:40,NemesisNemesi75,"Il y avait mille et une autres causes à défendre le soir de Noël. 

Et 55 personnalités ont choisi… de défendre #Depardieu dans le @Le_Figaro. 

Un bien bel esprit de Noël 🎅 « fabrandanne: La tribune de soutien à Gérard Depardieu a été mise en ligne le soir de Noël sur le site du Figaro. Elle n’a aucun mot pour les plaignantes et a été signée par une cinquantaine de personnalités, de Benoît Poelvoorde à Gérard Darmon, en passant par Afida Turner et Pierre Richard. https://twitter.com/fabrandanne/status/1739400506525520094/photo/1 — https://twitter.com/fabrandanne/status/1739400506525520094 »",37,172,21,230
123,1738846023739482565,2023-12-24 08:56:12,NemesisNemesi75,❄️Les filles du Collectif Némésis vous souhaitent par avance un joyeux #Noël et un bon réveillon ! ❄️ https://twitter.com/NemesisNemesi75/status/1738846023739482565/photo/1,582,3149,155,3886
124,1737830534439440717,2023-12-21 13:41:01,NemesisNemesi75,"Saint-Denis : une adjointe au maire agressée à coups de poing en pleine rue.

En charge des solidarités et du droit des femmes, Oriane Filhol a été violemment passée à tabac mercredi soir dans la rue alors qu’elle sortait d’une réunion de travail. 

Ses agresseurs, de type…",615,1503,150,2268
125,1737798078063649089,2023-12-21 11:32:03,NemesisNemesi75,". @CordierAlice2 a répondu ce matin sur @CNEWS à l’ignoble et diffamatoire émission @Cdanslair sur notre association diffusée hier soir sur France 5. 

Les journalistes ont sciemment tronqués des témoignages de nos militantes ayant subi du harcèlement pour les humilier. Le… https://twitter.com/NemesisNemesi75/status/1737798078063649089/video/1",603,1439,60,2102
126,1737563144954745066,2023-12-20 19:58:30,NemesisNemesi75,"Dans son reportage sur notre association diffusé ce soir sur #France5, @Cdanslair explique  que « d’autres groupes  se sont illustrés par leur violence » suggérant donc que nous serions un groupe violent ce qui est évidemment TOTALEMENT faux. 

Sur quoi vous basez-vous @Cdanslair… « CordierAlice2: Je découvre avec stupéfaction un reportage de France 5 pour @Cdanslair où la journaliste explique que nous sommes des « femmes blanches » qui nous battons contre « les hommes musulmans ».

Des femmes racontent leurs agressions dans la rue et elles sont traînées dans la boue ?… https://twitter.com/CordierAlice2/status/1737554541669752905/video/1 — https://twitter.com/cordieralice2/status/1737554541669752905 »",489,1120,19,1628
127,1737513294095622366,2023-12-20 16:40:25,NemesisNemesi75,"Patrick Poivre d’Arvor mis en examen pour le viol de Florence Porcel. 

La première plainte déposée par Florence Porcel avait déclenché l’ouverture d’une enquête préliminaire pilotée par le parquet. Dans le cadre de cette procédure, vingt-trois femmes avaient livré à la justice…",18,53,1,72
128,1737402765909926386,2023-12-20 09:21:13,NemesisNemesi75,"@GDarmanin Sans les voix des députés @RNational_off ? À ce niveau de mensonge, c’est pathologique.",10,263,2,275
129,1737400643864654161,2023-12-20 09:12:47,NemesisNemesi75,"La version durcie du texte a été adoptée mardi dans la soirée avec une large majorité : 349 députés ont voté en faveur du texte et 186 contre. 

Mais que contient réellement ce texte? Voici le résumé :

➡️Allocations familiales : un délai de cinq ans est prévu pour ceux qui ne…",315,846,40,1201
130,1737244023868317972,2023-12-19 22:50:26,NemesisNemesi75,"Cela fait pratiquement 20 ans que le site @Madmoizelle existe. Et la seule et unique fois où le site parle d’un viol commis par une personne sous OQTF c’est pour en dénoncer la «récupération». 

Pas un mot de compassion envers la victime. Pas un mot pour dire l’évidence: si la… « Madmoizelle: Comment le récit de Claire, victime de viol, est instrumentalisée par l’extrême droite
➡️ https://l.madmoizelle.com/ap https://twitter.com/Madmoizelle/status/1737076414896030030/photo/1 — https://twitter.com/madmoizelle/status/1737076414896030030 »",824,2284,37,3145
131,1737191504664215766,2023-12-19 19:21:44,NemesisNemesi75,"⚠️Nouvelle affaire de viol sur une femme âgée :

Mohammad D., un SDF français de 28 ans interpellé pour le viol d’une femme handicapée de 68 ans. 

Au cours de l’agression, la victime est parvenue à téléphoner à sa fille. Cette dernière n’a pas décroché mais la messagerie l’a…",862,1581,79,2522
132,1737101907192115390,2023-12-19 13:25:43,NemesisNemesi75,"Une femme a vécu un calvaire et a le courage de s’exprimer et on a ce genre de « féministe » qui lui intime l’ordre de se taire pour ne pas aller à l’encontre de son programme politique. 

Rarement vu des propos aussi gerbants. Ne venez plus jamais nous parler de sororité quand… « yeezlouise: Les viols sont commis dans tous les milieux sociaux mais Claire fait le tour des médias en plein milieu du passage de loi immigration profondément raciste afin de stigmatiser encore plus les étrangers et inciter à ce qu'il y a encore plus d'expulsions
https://twitter.com/BFMTV/status/1736678258664505448?t=xwq5Dur-9IWeDZ6NusQEIg&s=19 — https://twitter.com/yeezlouise/status/1736740174531383736 »",425,1433,30,1888
133,1737003249347985763,2023-12-19 06:53:41,NemesisNemesi75,"Le procès de Saïd Chabane s’est ouvert depuis lundi. L’ex-président et actuel propriétaire du club de football d'Angers est jugé jusqu'à mardi pour des agressions sexuelles ""commises par personne abusant de l'autorité que lui confère sa fonction"".

Au total se sont 7 femmes qui… https://twitter.com/NemesisNemesi75/status/1737003249347985763/photo/1",23,65,3,91
134,1737000894682571124,2023-12-19 06:44:19,NemesisNemesi75,"Incarcéré depuis 2021, Cyrille Adam, 72 ans, plus connu sous le pseudonyme Loup Blanc chaman, sera jugé par la cour criminelle du Gard dans les prochains mois pour viols, agressions sexuelles et abus de faiblesse.

Celui qui se revendique « descendant de grands chefs indiens»,…",29,87,1,117
135,1736999101923766686,2023-12-19 06:37:12,NemesisNemesi75,"Lyon : L’adolescente tabassée avait porté plainte pour viol contre le frère de l’une de ses agresseuses. Le frère accusé et les 4 agresseuses sont actuellement en liberté. 

https://m.20minutes.fr/amp/a/4067153",823,1102,42,1967
136,1736825440843583980,2023-12-18 19:07:08,NemesisNemesi75,"-Parce que comme votre propre bandeau sur twitter l’indique : liberté d’expression 

-Parce que c’est la vérité 

-Parce que cela aurait pu être évité

-Parce que ça n’aurait jamais dû arriver

-Parce que les OQTF non exécutées font des dizaines de victimes tous les mois

-Et… « r_chekkat: Pourquoi préciser que l'agresseur est sous OQTF ? En quoi la mention de sa situation administrative est-elle pertinente ? Une agression commise par un étranger est-elle plus grave que celle commise par un Français ? — https://twitter.com/r_chekkat/status/1736702466425602058 »",319,1309,17,1645
137,1736795879711899718,2023-12-18 17:09:40,NemesisNemesi75,"Pour rappel : actuellement, le règlement du concours Miss France exige que l’identité civile sur la carte d’identité soit féminine. Contrairement à l’ancien règlement à l’époque de Geneviève de Fontenay qui indiquait qu’il fallait « être née de sexe féminin ».

Cependant, toute…",8,32,1,41
138,1736795874796171469,2023-12-18 17:09:39,NemesisNemesi75,"🎤 MICRO-TROTTOIR🎤

En 2022 pour la première fois, une personne transgenre a tenté sa chance au concours #MissFrance . Notre @enfantdefrance7 est alléz interroger les Dijonnais sur l’ouverture aux personnes trans de ce concours mythique.

➡️Et vous, qu’en pensez-vous ? https://twitter.com/NemesisNemesi75/status/1736795874796171469/video/1",53,193,19,265
139,1736784079884882167,2023-12-18 16:22:47,NemesisNemesi75,"Un Tunisien 🇹🇳 né en 1988 a été mis en examen pour viols et agressions sexuelles et placé en détention provisoire. Il sévissait dans les transports en communs franciliens. Il a agressé au moins 4 femmes. 

https://www.bfmtv.com/paris/paris-un-homme-interpelle-pour-des-agressions-sexuelles-et-tentatives-de-viol-dans-les-transports_AN-202312180575.html",546,832,24,1402
140,1736318859932467517,2023-12-17 09:34:10,NemesisNemesi75,"Notre réponse parodique à cette campagne de sécurité totalement lunaire de la ville de @Johanna_Rolland. 

➡️Demander aux femmes de sortir en groupe en France est un aveu d’échec total pour une ville qui souhaitait « faire de #Nantes la première ville non sexiste de France d’ici… https://twitter.com/NemesisNemesi75/status/1736318859932467517/video/1 « nantesfr: 🎥 1er volet de notre nouveau format ""La #sécurité, on en parle"", qui donne la parole aux Nantaises et aux Nantais. 
👮‍♂️ Retrouvez les réponses de nos agents de la police municipale, qui agissent sur le terrain au quotidien, en lien avec @PoliceNat44, la PMTC et nos partenaires. https://twitter.com/nantesfr/status/1706696184222371921/video/1 — https://twitter.com/nantesfr/status/1706696184222371921 »",863,1935,49,2847
141,1736044414483488797,2023-12-16 15:23:37,NemesisNemesi75,"@Meogjaoeg @PeterColumns C’est un mythe qui a la vie dure mais qui est globalement faux.

Les femmes votaient moins à gauche (entre 10 et 13 points de moins que les hommes de 1946 à 1973, puis de 5 à 9 points jusqu'en 1981). Il est vrai qu’elles accordaient en revanche moins de suffrages à l'extrême…",20,77,6,103
142,1735704503679082834,2023-12-15 16:52:56,NemesisNemesi75,"@Isra______al @Valeurs Ce qui est surtout dommage pour toi c’est que nous, on se fout de l’origine des victimes et des agresseurs. Que la victime s’appelle Morgane ou Shaina ou que l’agresseur s’appelle Yassine ou Gerard on en parle.",61,435,11,507
143,1735628548868575526,2023-12-15 11:51:07,NemesisNemesi75,"«Ce que l’on peut voir là, c’est le coté ""clanique"" de certaines communautés (…) Tu as touché au clan, je vais te le faire payer coûte que coûte. Tu as accusé mon frère d’agression sexuelle, peu importe si tu dis vrai ou pas, je vais te le faire payer ».

@CordierAlice2 est… https://twitter.com/NemesisNemesi75/status/1735628548868575526/video/1",404,959,37,1400
144,1735617185563770883,2023-12-15 11:05:57,NemesisNemesi75,@arabe_de_gauche @Valeurs Ben oui Vegeta. Si tu as une vidéo de la situation inverse n’hesite pas à nous l’envoyer on la postera sans problèmes.,19,635,7,661
145,1735609327296053331,2023-12-15 10:34:44,NemesisNemesi75,@arabe_de_gauche @Valeurs Ben évidemment que non.,18,720,1,739
146,1735603836193026517,2023-12-15 10:12:55,NemesisNemesi75,"Nous apprenons par @Valeurs que l’insoutenable vidéo de la jeune fille rouée de coups à Lyon est en fait une expédition punitive pour empêcher une victime d’agression sexuelle de parler :

Un certain Yassine (le frère de la femme voilée qui porte les coups les plus violents)…",2019,4493,102,6614
147,1735396242543587619,2023-12-14 20:28:00,NemesisNemesi75,"On arrêtera de diffuser les vidéos quand vous passerez plus de temps à traquer les auteurs de ce genre de méfaits plutôt que ceux qui partagent la dite vidéo « prefetrhone: Une vidéo circule actuellement sur les réseaux sociaux montrant une jeune fille se faire agresser. 

Merci de ne pas la diffuser par respect pour la victime ⚠️

Les autorités compétentes ont été saisies. — https://twitter.com/prefetrhone/status/1735344537306837283 »",1792,6210,111,8113
148,1735279088992960713,2023-12-14 12:42:29,NemesisNemesi75,"Khaledin Sakhidad, un livreur de repas condamné à 12 ans de réclusion pour avoir violé une femme SDF à Rennes en novembre 2020.

Elle avait expliqué, en larmes, qu’un livreur travaillant pour Uber Eats l’avait abordée et lui avait demandé si elle voulait quelque chose à manger.…",272,535,18,825
149,1735233805395394829,2023-12-14 09:42:32,NemesisNemesi75,"Le RAID intervient pour une femme de 34 ans séquestrée par deux hommes près l’Angoulême. 

Parmi les auteurs de la séquestration, son ex-compagnon. L'ex-compagnon, âgé de 33 ans, est défavorablement connu des services de police et de justice. Il a déjà été condamné à 15 reprises.…",464,942,42,1448
150,1735231789524824315,2023-12-14 09:34:32,NemesisNemesi75,"Jonathan C-M, 30 mentions au casier dont 7 pour violences, est accusé de s’être introduit au domicile de son ex-compagne, de l’avoir agressée et menacée de mort avec un couteau le 21 novembre dernier alors que celui-ci avait interdiction de rentrer en contact avec la victime.…",38,99,4,141
151,1735225123840405557,2023-12-14 09:08:03,NemesisNemesi75,"Encore un viol correctionnalisé en simple agression sexuelle par la justice : 

Un homme de 39 ans a été condamné par le tribunal judiciaire de Cherbourg mardi 12 décembre 2023, à seulement une peine ferme sous surveillance électronique pour agression sexuelle et violences sur…",102,259,8,369
152,1735030530184270322,2023-12-13 20:14:48,NemesisNemesi75,"Nous lisons entre les lignes : «Pour voyager tranquille, mieux vaut porter un hijab ». Les frères musulmans font la comm de la Commission européenne où quoi ? Elle ne sait pas faire une seul document sans y mettre des femmes voilées dedans « F_Desouche: ""Vous pouvez voyager l'esprit tranquille dans l'UE"" : dans son dernier ""Petit guide de l'UE"", la Commission européenne fait une nouvelle fois la promotion du hijab
https://www.fdesouche.com/2023/12/13/vous-pouvez-voyager-lesprit-tranquille-dans-lue-dans-son-dernier-petit-guide-de-lue-la-commission-europeenne-fait-une-nouvelle-fois-la-promotion-du-hijab/ https://twitter.com/F_Desouche/status/1734989834270183802/photo/1 — https://twitter.com/f_desouche/status/1734989834270183802 »",674,1320,27,2021
153,1734920774467637476,2023-12-13 12:58:40,NemesisNemesi75,@MickNovitch @admirbarrio Ce genre de réflexion… on dirait vraiment les PNJ dans les jeux vidéos qui n’ont que quelques phrases à dire et qui tournent en boucle à l’infini.,0,108,4,112
154,1734916086162710733,2023-12-13 12:40:02,NemesisNemesi75,"Paris : au cri d’«Allah Akbar», un homme muni d’un couteau de cuisine de 40  menace une femme et lui demande si elle est juive.

Alors que cette femme venait de lui répondre négativement, il lui aurait alors dit : «Tu as de la chance sinon tu aurais pris ça (le couteau, NDLR)…",177,395,17,589
155,1734896015235285151,2023-12-13 11:20:17,NemesisNemesi75,@admirbarrio Peut-être parce que tu te bats H24 contre les mauvaises personnes 🤷🏻‍♀️,52,1869,23,1944
156,1734895249237868956,2023-12-13 11:17:14,NemesisNemesi75,@P3paga Source : Evian,2,20,5,27
157,1734885886112694731,2023-12-13 10:40:02,NemesisNemesi75,"Tant de viols, d’agressions sexuelles et de meurtres seraient épargnés aux Françaises si on arrêtait de laisser venir en masse n’importe qui chez nous. 

C'est abominable ce qu'on fait subir à nos soeurs et à nos grands-mères au nom de la «diversité», et du politiquement correct.… https://twitter.com/NemesisNemesi75/status/1734885886112694731/photo/1",772,1875,38,2685
158,1734882473182392824,2023-12-13 10:26:28,NemesisNemesi75,"À Saint-Malo, un jeune homme assisté par un interprète écope seulement de 5 mois de prison avec sursis pour avoir frappé au visage sans aucune raison deux jeunes femmes et de 4 mois de prison avec sursis pour l’agression sexuelle d’une jeune fille de 15 ans qu’il avait bloquée…",698,1198,50,1946
159,1734878233600917797,2023-12-13 10:09:38,NemesisNemesi75,"Une adolescente de 14 ans violée dans un squat à Avignon. Les faits se sont produits proche du point de deal du Ponzo, à Monclar. L’homme a été décrit par les victimes comme « parlant un français très approximatif ».

L’auteur a aussi tenté de violer une femme de 23 ans sous la…",181,320,5,506
160,1734868859587289557,2023-12-13 09:32:23,NemesisNemesi75,"⚠️Demain s’ouvrira le procès pour viol de Yero Ba, qui a violé Océane Decan dans un parking du centre de Bordeaux, sous la menace d’un couteau en 2021. ⚠️

Le suspect a été remis en liberté en septembre dernier sans que la victime en soit mise au courant. Elle a appris sa remise…",874,1791,140,2805
161,1734862758556946874,2023-12-13 09:08:08,NemesisNemesi75,"À Cherbourg le 5 décembre, une jeune femme de 19 ans a été violée en pleine rue. Un homme de 34 ans de nationalité française a été écroué. Il aurait aussi violé une ainsi autre jeune femme de 18 ans à Gennevilliers en région parisienne.

https://actu17.fr/faits-divers/manche-une-jeune-femme-de-19-ans-violee-en-pleine-rue-un-homme-de-34-ans-ecroue.html",71,169,5,245
162,1734858820172632218,2023-12-13 08:52:29,NemesisNemesi75,"Une enseignante d'un collège des Yvelines a été menacée après avoir montré à ses élèves de sixième ""Diane et Actéon"" du Cavalier d'Arpin, un tableau sur lequel figurent des femmes nues.

L'enseignante est accusée de racisme, car elle aurait cherché à choquer les élèves musulmans… https://twitter.com/NemesisNemesi75/status/1734858820172632218/photo/1",200,472,20,692
163,1734546890920730743,2023-12-12 12:12:59,NemesisNemesi75,"Encore une femme âgée violée chez elle : un homme de nationalité ivoirienne en situation irrégulière et sous OQTF vient d’être interpellé pour le viol d’une femme de 65 ans à son domicile dans les Yvelines.

Séquestrée, la victime a été violée à plusieurs reprises. A l'arrivée…",591,1062,36,1689
164,1734514965900329408,2023-12-12 10:06:08,NemesisNemesi75,"Une surveillante pénitentiaire a été victime d'une violente agression dans la rue à Roubaix lundi 4 décembre. Elle a été reconnue puis rouée de coups par trois hommes, qui ont pris la fuite. L’un d’entre eux a filmé la scène avec son téléphone. 

https://actu17.fr/faits-divers/roubaix-une-surveillante-penitentiaire-reconnue-et-rouee-de-coups-en-pleine-rue.html",292,404,14,710
165,1734510149379797078,2023-12-12 09:46:59,NemesisNemesi75,"On croit à tort que les femmes âgées ne peuvent plus être victimes de viols ou d’agressions sexuelles. Ces dernières années, il se passe rarement une semaine sans qu’une femme de l’âge de notre grand-mère soit victime chez elle, dans la rue, dans sa chambre d’hôpital ou dans son…",814,1686,49,2549
166,1734278547244490797,2023-12-11 18:26:41,NemesisNemesi75,Oh non c’est au tour du projet de loi immigrationniste de #Darmanin d’être dissous 🥲 https://twitter.com/NemesisNemesi75/status/1734278547244490797/photo/1,214,1037,17,1268
167,1734269177769214139,2023-12-11 17:49:27,NemesisNemesi75,"Paris : un Tunisien mis en examen pour 5 agressions sexuelles et tentatives de viol dans le métro.

Le suspect agissait selon le même mode opératoire : il se ruait sur des usagères, les faisait chuter au sol puis tentait de les déshabiller. 

https://www.lefigaro.fr/faits-divers/paris-un-predateur-sexuel-qui-sevit-dans-le-metro-activement-recherche-20231208",332,487,22,841
168,1734259900560138450,2023-12-11 17:12:35,NemesisNemesi75,".@CordierAlice2 était invitée aujourd’hui sur le plateau de @CNEWS pour parler du projet de loi sur l’immigration débattu en ce moment à l’Assemblée Nationale.

➡️Elle a pu mettre en avant l’impact négatif d’une certaine immigration sur les femmes: https://twitter.com/NemesisNemesi75/status/1734259900560138450/video/1",288,828,22,1138
169,1734218579082453395,2023-12-11 14:28:24,NemesisNemesi75,"Mustafa Sat, un herboriste de 73 ans, déjà condamné en 2021, est de nouveau jugé pour deux viols et six agressions sexuelles par six femmes. 

https://www.leprogres.fr/faits-divers-justice/2023/12/06/herboriste-juge-pour-viol-elles-ont-mal-saisi-mes-gestes",130,216,13,359
170,1734215360994222081,2023-12-11 14:15:36,NemesisNemesi75,Le dissolvant de la République https://twitter.com/NemesisNemesi75/status/1734215360994222081/photo/1,25,74,2,101
171,1734165271022092727,2023-12-11 10:56:34,NemesisNemesi75,"Même le journal @HuffPost, pourtant à gauche, admet que @GDarmanin s’est trompé en attribuant à @AcademiaChristi des propos tenus par Civitas, dissoute en octobre. 

Les gens qui nous dirigent ne savent même pas ce qu’ils font. Preuve éclatante que la dissolution d’Academia… https://twitter.com/NemesisNemesi75/status/1734165271022092727/photo/1",556,1130,22,1708
172,1734158418800165296,2023-12-11 10:29:20,NemesisNemesi75,"Les 19 et 20 décembre prochain, Berliche-Emmanuel M.I., un SDF de 21 ans, comparaîtra devant la cour d’assises de l’Aube pour violation de domicile, extorsion et viol.

Les faits qui lui sont reprochés remontent à l’été 2021. Cette nuit-là, le jeune homme, qui comptait cambrioler…",47,114,6,167
173,1734131162937790584,2023-12-11 08:41:02,NemesisNemesi75,"Merci à @WatrigantArthur qui a dénoncé sur @CNEWS la clôture de notre compte bancaire par le @CreditMutuel et nos problèmes pour retrouver une autre banque. 

L’actualité montre que nous dérivons de plus en plus vers un régime autoritaire qui persécutera toutes les personnes ou… « WatrigantArthur: Un exemple de plus du totalitarisme sans le goulag brillamment analysé par Mathieu Bock-Côté : le collectif féministe @NemesisNemesi75 viré de leur banque pour idées non conformes à la doxa. https://twitter.com/WatrigantArthur/status/1734123243525505508/video/1 — https://twitter.com/watrigantarthur/status/1734123243525505508 »",700,1508,28,2236
174,1734126642614694209,2023-12-11 08:23:04,NemesisNemesi75,"VICTOIRE ! 

Le lycée musulman Averroès de #Lille contre lequel nous avions réalisé une action en septembre dernier pour dénoncer ses lectures salafistes perd enfin ses financements publics. L’établissement touchait un demi-million d’euros de subventions annuelles.

Pour rappel,…",951,3127,97,4175
175,1734123322625921032,2023-12-11 08:09:53,NemesisNemesi75,"Johan M., un Gabonais de 39 ans, est jugé à partir de ce lundi pour 15 viols et agressions sexuelles sur des aspirantes mannequins parfois mineures.

https://www.leparisien.fr/faits-divers/proces-pour-viols-les-machiaveliques-stratagemes-du-recruteur-de-mannequins-11-12-2023-TFH7DG7ZHFG5XBRIWA2AJ25OI4.php",161,204,1,366
176,1733923687022096711,2023-12-10 18:56:36,NemesisNemesi75,"Ouf 😮‍💨 nous nous sentons vraiment plus en sécurité maintenant que le mouvement @AcademiaChristi a été dissous @GDarmanin 🤡.

Blague à part quand seront enfin dissous des mouvements réellement violent comme @jeune_garde ou @AFA_Paris75 ? Pourquoi les protégez-vous à ce point ? « Le_Figaro: Gérald Darmanin annonce la dissolution d'Academia Christiana, un mouvement catholique traditionaliste
https://www.lefigaro.fr/politique/gerald-darmanin-annonce-la-dissolution-d-academia-christiana-un-mouvement-catholique-traditionaliste-20231210 ↓ — https://twitter.com/le_figaro/status/1733904193457361060 »",696,1825,52,2573
177,1733770486876700982,2023-12-10 08:47:50,NemesisNemesi75,@REMPLACEMENT_TV Source : Evian,0,49,1,50
178,1733511268718330051,2023-12-09 15:37:48,NemesisNemesi75,@LeBobFisher @arabe_de_gauche 🤌🏻,0,4,1,5
179,1733496682438852926,2023-12-09 14:39:50,NemesisNemesi75,@arabe_de_gauche tu ne sais de toute façon probablement pas lire l’heure sur ta Rolex,11,399,6,416
180,1733474165867331734,2023-12-09 13:10:22,NemesisNemesi75,"L’homme en situation irrégulière suspecté de viol et d’agression sexuelle sur deux touristes brésiliennes, dans la nuit du 4 au 5 février dernier, au Champs de Mars, à Paris, était connu sous différents alias. D’une part comme étant Khalid Karam, né le 3 juin 1997, en Italie. Et… https://twitter.com/NemesisNemesi75/status/1733474165867331734/photo/1",540,845,50,1435
181,1733467856434606559,2023-12-09 12:45:17,NemesisNemesi75,"Désolé de te contredire Vegeta mais d’après une étude de l'Ifop, les Parisiennes expriment majoritairement leur refus de s’unir avec des hommes originaires d’Afrique sub-saharienne (62 %) ou du Maghreb/Moyen-Orient (57%).

https://www.ifop.com/publication/coucheruez-vous-avec-un-mec-du-9-3-enquete-sur-le-poids-des-origines-et-du-lieu-de-residence-dans-le-choix-du-conjoint-des-parisiens/

Pleins d’études menées aux…",302,1685,92,2079
182,1733156456227131613,2023-12-08 16:07:54,NemesisNemesi75,"Limay : Une femme de 65 ans séquestrée et violée à son domicile, un suspect interpellé. C’est un homme en situation irrégulière de 26 ans déjà connu des services de police.

https://actu17.fr/faits-divers/limay-une-femme-de-65-ans-sequestree-et-violee-a-son-domicile-un-suspect-interpelle.html",446,736,40,1222
183,1733098463653503066,2023-12-08 12:17:27,NemesisNemesi75,"À Vierzon, un homme de 48 ans a été condamné à 12 ans de réclusion criminelle ce mercredi 6 décembre, pour viol sur son ex-compagne. Présent au début de son procès, mais pas lors du verdict, l'homme est activement recherché. Un mandat d'arrêt émis contre lui.…",50,144,3,197
184,1733096945298690108,2023-12-08 12:11:25,NemesisNemesi75,"L’un des deux agresseurs, suspectés d'avoir violé une touriste brésilienne et sa sœur au Champ-de-Mars en février dernier, a été interpellé mardi soir à la gare Saint-Lazare. Il s'agit d'un homme de 26 ans, de nationalité marocaine, présenté comme un sans domicile.…",824,1533,69,2426
185,1732815526743732493,2023-12-07 17:33:10,NemesisNemesi75,"Extrait de l’émission ""Complément d’enquête"" de ce soir sur Gérard Depardieu à voir sur France 2 à 23h. 

Nous pouvons y voir un Gérard Depardieu multipliant les commentaires obscènes notamment sur une petite fille nord-coréenne de 10 ans. 

➡️Pour rappel, une nouvelle plainte… https://twitter.com/NemesisNemesi75/status/1732815526743732493/video/1",78,269,73,420
186,1732703800832516316,2023-12-07 10:09:12,NemesisNemesi75,"Kevin P. (35 ans) est jugé pour le meurtre de son ex-compagne Angélique Clere (32 ans) tuée par arme à feu en pleine rue en juin 2021 à à Monéteau. L'homme, était déjà connu des services de police et de la justice pour des faits de violence envers la victime. ""…",55,166,10,231
187,1732453730027503695,2023-12-06 17:35:31,NemesisNemesi75,"@acormierd Merci, ami de la Nouvelle-France (la vraie ;) 🙏",0,86,0,86
188,1732435101634478224,2023-12-06 16:21:29,NemesisNemesi75,"@marxovitch Depuis quand porter une robe c’est bourgeois ? Vous savez, contrairement à vos fantasmes, il n’y a pas que les bourgeois qui savent s’habiller.",3,86,4,93
189,1732430620570141130,2023-12-06 16:03:41,NemesisNemesi75,"Lille : Samedi 2 décembre, une femme a été violemment agressée lors du vol de son scooter par individus de 16 ans et un homme de 18 ans qui l’attendaient à un feu rouge.

https://www.lavoixdunord.fr/1404780/article/2023-12-04/lille-une-femme-violemment-agressee-lors-du-vol-de-son-scooter

@MartineAubry @lillefrance",70,164,13,247
190,1732350220736844006,2023-12-06 10:44:12,NemesisNemesi75,"L’ @ENS_ULM forme les élites du pays. Beaucoup de leurs étudiants se retrouvent ensuite à l’ENA et deviennent hauts fonctionnaires ou encore professeurs dans les universités françaises.

Nous venons d’apprendre que cette école organise ce mercredi 6 décembre un repas caritatif en… https://twitter.com/NemesisNemesi75/status/1732350220736844006/photo/1",554,1021,36,1611
191,1732330003243655196,2023-12-06 09:23:52,NemesisNemesi75,@marxovitch Pour info le communiste qui utilise Twitter : le survet Lacoste et le shit de tes racailles adorées coûtent plus cher que nos robes et notre vin.,127,1455,21,1603
192,1732324481182384612,2023-12-06 09:01:56,NemesisNemesi75,"""La migration est normale.
Les migrations ont toujours existé.
Les migrations existeront toujours.
La migration fait partie de l’être humain.
Il y aura toujours des migrants.
Il n’est donc pas question d’arrêter les migrations. Cela n’arrivera jamais et c’est impossible. Et ce… https://twitter.com/NemesisNemesi75/status/1732324481182384612/photo/1",545,1308,221,2074
193,1732037866937864601,2023-12-05 14:03:01,NemesisNemesi75,"#Boycott @MyproteinFR « milafique: Prôner l’inclusion et exclure… Voici le message que m’envoie @MyProteinFR J’ai, ces derniers temps, publié des messages en soutien à #Thomas Fière d’être du côté de la vie, et non de la barbarie, je ne me tairai pas. Halte à la censure au nom d’une prétendue bienveillance ! https://twitter.com/milafique/status/1732030498325532951/photo/1 — https://twitter.com/milafique/status/1732030498325532951 »",638,1673,20,2331
194,1731982480398274939,2023-12-05 10:22:56,NemesisNemesi75,https://www.nicematin.com/justice/-la-victime-est-vulnerable-sous-une-emprise-totale-frappee-brulee-humiliee-elle-defend-son-bourreau-889315,11,43,0,54
195,1731982478288564379,2023-12-05 10:22:56,NemesisNemesi75,"“J’ai retiré ma plainte. Je veux qu’il sorte de prison. Je ne suis pas partie civile (…)Je suis consciente que ce qu’il a fait est horrible mais je ne peux vivre sans lui”

Ce sont les mots de Marine, victime de violences conjugales de la part de son compagnon Hessine Dhifi, un… https://twitter.com/NemesisNemesi75/status/1731982478288564379/photo/1",257,642,106,1005
196,1731970010749321236,2023-12-05 09:33:23,NemesisNemesi75,"Le procès en appel de Nicolas Zepeda, un homme de nationalité chilienne, a débuté hier.

Il est accusé de l'assassinat de son ex-petite amie Narumi Kurosaki en 2016 à Besançon. Il a été condamné en première instance à 28 ans de réclusion criminelle. 

Suivre le déroulé du procès… https://twitter.com/NemesisNemesi75/status/1731970010749321236/photo/1",17,65,2,84
197,1731966603653202247,2023-12-05 09:19:51,NemesisNemesi75,"Api Ratuniyarawa, un ancien rugbyman du Top 14 accusé d'agression sexuelle sur trois femmes en une soirée : un mois après avoir nié en bloc, il reconnaît les faits.

Il aurait ""plaidé coupable à deux chefs d'agression par pénétration"" et à ""un chef d'accusation d'agression… https://twitter.com/NemesisNemesi75/status/1731966603653202247/photo/1",95,229,13,337
198,1731961901842657376,2023-12-05 09:01:10,NemesisNemesi75,⚠️ N’oubliez pas de confirmer votre email dans votre boite mail pour que votre signature soit prise en compte ⚠️,8,44,0,52
199,1731960625109086429,2023-12-05 08:56:05,NemesisNemesi75,".@moicestyasin, le frère de Shaina, poignardée et brûlée vive alors qu’elle était enceinte par Omar en octobre 2019 a besoin de vous :

En 2021 la mairie de @Ville_de_Creil avait fait une promesse : faire du lieu où la jeune Shaïna avait été assassinée un lieu de mémoire. Mais la… « moicestyasin: 4 ans après la mort de Shaïna je suis au point de faire une pétition car promesse non tenue par le Maire de Creil 
J’ai vraiment besoin de votre aide afin d’obtenir un lieu de recueillement  si vous pouvez signer ma pétition svp  ici a Creil tout le monde nous a abandonné — https://twitter.com/moicestyasin/status/1731734701797253205 »",229,493,12,734
200,1731957773334634978,2023-12-05 08:44:46,NemesisNemesi75,"Une femme âgée de 30 ans a été tuée à coups de couteau à Drancy (Seine-Saint-Denis) dans la nuit de lundi à mardi. L'un de ses fils, qui a été placé en garde à vue. Ce dernier a légèrement blessé un policier.

La victime avait reçu une trentaine de coups à l'arme blanche…",62,142,12,216
201,1731956158649295050,2023-12-05 08:38:21,NemesisNemesi75,"Arles : Une femme de 89 ans frappée dans la rue pour son porte-monnaie contenant 20 euros et son téléphone.

https://actu17.fr/faits-divers/arles-une-femme-de-89-ans-frappee-dans-la-rue-pour-son-porte-monnaie-et-son-telephone.html",98,172,9,279
202,1731954332356980739,2023-12-05 08:31:05,NemesisNemesi75,"PROSTITUTION DE MINEURE : Deux jeunes hommes de 18 et 19 ans ont été interpellés par les policiers à Rouen (Seine-Maritime) dimanche soir. Ils sont soupçonnés d'avoir forcé une adolescente de 14 ans à se prostituer dans un appartement.

Les deux proxénètes présumés sont déjà…",145,307,17,469
203,1731762469989679174,2023-12-04 19:48:42,NemesisNemesi75,"Toujours là quand l’accusé s’appelle Mathias, jamais là quand il s’appelle Malik. Ça commence vraiment à se voir @sandrousseau « sandrousseau: Ah ces délinquants de quartier, qui imposent à leurs compagnes leur violence. — https://twitter.com/sandrousseau/status/1731702870771106059 »",333,1683,17,2033
204,1731741602043879829,2023-12-04 18:25:46,NemesisNemesi75,"Deux nuits de GAV pour avoir collé ces affiches à la mémoire de #Thomas puis une perquisition indécente. C’est extrêmement choquant. Soutien évidemment à @TLebrac et ses amis. https://twitter.com/NemesisNemesi75/status/1731741602043879829/photo/1 « TLebrac: Chose promise, chose dûe; 

Tout commence avec le meurtre du jeune Thomas. Un jeune français de 16 ans, qui sort aux bals de villages, c'est exactement moi il y a dix ans.
Autant vous dire que je me suis vite identifié à lui et ai été particulièrement révolté. — https://twitter.com/tlebrac/status/1731702231588622704 »",1522,3998,77,5597
205,1731707304666431622,2023-12-04 16:09:29,NemesisNemesi75,"Le directeur de Sciences Po Paris, Mathias Vicherat, placé en garde à vue pour violences conjugales
La compagne de M. Vicherat a également été placée en garde à vue, chacun accusant l’autre de violences conjugales.

https://www.lemonde.fr/societe/article/2023/12/04/le-directeur-de-sciences-po-paris-mathias-vicherat-place-en-garde-a-vue-pour-violences-conjugales_6203849_3224.html https://twitter.com/NemesisNemesi75/status/1731707304666431622/photo/1",61,194,24,279
206,1731675715110650240,2023-12-04 14:03:58,NemesisNemesi75,"Yusuf V. un maçon de 30 ans explique à son procès pour viol souffrir de ""somnambulisme sexuel» 

Il est jugé à partir d’aujourd’hui et jusqu’à demain à la cour criminelle de la Moselle pour le viol de son ex-petite amie et sur une amie de cette dernière le soir du nouvel an 2022.…",116,308,25,449
207,1731666891104514058,2023-12-04 13:28:54,NemesisNemesi75,@ayb_elma @mathildaNemesis https://twitter.com/NemesisNemesi75/status/1731666891104514058/photo/1,5,429,4,438
208,1731664189549085086,2023-12-04 13:18:10,NemesisNemesi75,"Il faut comprendre qu’il y a une nouvelle maladie psychiatrique qui pousse des gens atteints d’islamisme aiguë à tuer des gens. Son variant judéo-chrétien n’existe pas cependant. Un vaccin vite 💉 💉🙃 « christine_kelly: -Sarah Halimi▶️Troubles psy

-Victimes de Merah ▶️Troubles psy

-Lola▶️Troubles psy

-Bébés d’Annecy▶️Troubles psy 

-Mireille Knoll▶️Troubles psy 

-Collin à Paris hier soir▶️Troubles psy 

…….Que comprendre ? 🤪

#Iman #AttaqueAuCouteau #AttaqueParis — https://twitter.com/christine_kelly/status/1731397689840116170 »",348,1221,27,1596
209,1731606744361566711,2023-12-04 09:29:54,NemesisNemesi75,"Coucou c’est nous @MartineAubry.

On espère que le message est passé et que votre mairie ne renouvellera pas ses subventions à l’association @lacimade en 2024. Sinon on va être obligées de continuer 🙃. 

(D’ailleurs on espère aussi que les Lillois ne vous rééliront pas comme… https://twitter.com/NemesisNemesi75/status/1731606744361566711/photo/1",480,1455,22,1957
210,1731599390123389188,2023-12-04 09:00:40,NemesisNemesi75,"Fin juillet 2021, la cour d’appel de Bâle en Suisse avait réduit la peine d’un violeur étranger de 51 mois de prison à 36 mois dont 18 ferme. Son expulsion du territoire suisse était quant à elle passée de huit à six ans. La raison ? Le viol avait été « de courte durée ».

En…",143,387,18,548
211,1731595764684476681,2023-12-04 08:46:16,NemesisNemesi75,"Christian Kozlowski a été condamné vendredi à seulement 12 ans de réclusion pour le meurtre de sa femme  Valérie Piwinski le 24 janvier 2018. 

L’homme de 56 ans, ancien gendarme, avait déjà été condamné deux fois pour des violences.

La victime avait confié à une amie qu'elle…",21,96,3,120
212,1731586362548146403,2023-12-04 08:08:54,NemesisNemesi75,"Mardi 28 novembre près de Béziers, une femme a été rouée de coups et laissée pour morte à son domicile.

Trois personnes seraient entrées de force à son domicile. Ils l’auraient roué de coups à tel point que la victime a perdu connaissance.

La victime a été hospitalisée dans un… https://twitter.com/NemesisNemesi75/status/1731586362548146403/photo/1",397,847,42,1286
213,1731421595275554821,2023-12-03 21:14:11,NemesisNemesi75,"Nos militantes ont souhaité répondre au magazine de mode @Dazed . Qu’en pensez-vous ? 😎 

source : @enfantdefrance7 https://twitter.com/NemesisNemesi75/status/1731421595275554821/photo/1",3218,16353,1971,21542
214,1731268365363068931,2023-12-03 11:05:18,NemesisNemesi75,"« Pour la sécurité des femmes, on ne devrait pas avoir besoin d’applications : on a surtout besoin que notre gouvernement mettent les lois en application »

➡️Notre message au gouvernement d’ @Elisabeth_Borne concernant sa « campagne » de prévention pour la sécurité des femmes… https://twitter.com/NemesisNemesi75/status/1731268365363068931/video/1",120,282,19,421
215,1731250639299055975,2023-12-03 09:54:52,NemesisNemesi75,"S’il y avait un Darwin award des tweets : « kamilabderrahmn: Pour tous ceux qui sont adeptes d’une sociologie criminelle qui se base sur les prénoms, le fou qui a tué un allemand ce soir à Paris s’appelle Armand. — https://twitter.com/kamilabderrahmn/status/1731087572607053919 »",36,342,13,391
216,1731241716961681450,2023-12-03 09:19:24,NemesisNemesi75,@OldenSnake Raté,15,1091,2,1108
217,1731233231242960943,2023-12-03 08:45:41,NemesisNemesi75,"@NZadourian Vous êtes ravagés il faut penser à consulter. Votre arrogance et votre sentiment d’impunité est écoeurant. Ne vous inquiétez pas, nous aussi on attend la libération.",7,49,4,60
218,1731231147261059288,2023-12-03 08:37:24,NemesisNemesi75,Nous rêvons ou une avocate souhaite voir une femme tondue ? Vous allez bien @NZadourian ?,103,353,15,471
219,1731068470199021739,2023-12-02 21:50:59,NemesisNemesi75,"Un couple a été agressé aux alentours de 21h45 à proximité de la Tour Eiffel. L'homme est mort. La femme a été prise en charge en urgence relative.

L'auteur, âgé de 26 ans, a attaqué plusieurs personnes à différents endroits, en pleine rue. Toujours selon nos informations, cet…",1078,2247,159,3484
220,1731000654548607426,2023-12-02 17:21:31,NemesisNemesi75,"😈Nos militantes lilloises ont encore frappé 😈:

Aujourd’hui, pendant le marché de Noël de #Lille, elles ont déployé une banderole pour dénoncer les agissements de l’association @lacimade .

➡️La Cimade est une association qui aide les clandestins à rester sur le territoire… https://twitter.com/NemesisNemesi75/status/1731000654548607426/video/1",1222,3021,95,4338
221,1730988878322942293,2023-12-02 16:34:43,NemesisNemesi75,L’une de nos militantes nantaise @naonedalice s’exprime sur les interdictions des rassemblements pour #Thomas : « naonedalice: Pour Thomas. Puisse son prénom ne jamais être oublié. https://twitter.com/naonedalice/status/1730985298870391012/video/1 — https://twitter.com/naonedalice/status/1730985298870391012 »,337,988,11,1336
222,1730852742153838947,2023-12-02 07:33:46,NemesisNemesi75,Notre presidente @CordierAlice2 a pris la parole hier lors du rassemblement pour Thomas à Panthéon : « Livrenoirmedia: 👉 « On ne peut plus accepter cet écart de culture » : prise de parole de @CordierAlice2 lors du rassemblement rendant hommage à #Thomas https://twitter.com/Livrenoirmedia/status/1730660842411045164/video/1 — https://twitter.com/livrenoirmedia/status/1730660842411045164 »,515,1863,34,2412
223,1730578772452085795,2023-12-01 13:25:06,NemesisNemesi75,"Vingt ans de prison. 

C'est la condamnation prononcée ce mercredi à Bienne en Suisse contre un Afghan reconnu coupable d'assassinat.
En avril 2022, il avait tué sa femme sous les yeux des cinq enfants du couple, dans un centre d'hébergement collectif. 

La victime, également…",121,351,15,487
224,1730576907207381410,2023-12-01 13:17:41,NemesisNemesi75,"Amiens : Une femme de 31 ans d’origine roumaine retrouvée morte, tuée à l'arme blanche dans un appartement. 

La police judiciaire, explore notamment la piste d'une activité de prostitution de la victime.

https://actu17.fr/faits-divers/amiens-une-femme-tuee-a-larme-blanche-dans-un-appartement.html",24,59,0,83
225,1730482029790208383,2023-12-01 07:00:41,NemesisNemesi75,"La courageuse maire divers droite de Romans-sur-Isere @MH_Thoraval est victime de graves menaces.

Elle confirme avoir reçu deux coups de téléphone la qualifiant de ""facho"" et un message d'une grande violence sur les réseaux sociaux, la menaçant de ""décapitation"".

Elle a annoncé… https://twitter.com/NemesisNemesi75/status/1730482029790208383/photo/1",1416,3629,107,5152
226,1730472220978225276,2023-12-01 06:21:42,NemesisNemesi75,"Bravo pour votre courage @MH_Thoraval . Nous sommes de tout coeur avec vous et espérons que votre plainte aboutira très rapidement. « MH_Thoraval: Depuis que j’ai décidé de dire tout haut ce que tout le monde pense tout bas, je suis l’objet de pressions.
Hier, un cap a été franchi, J’ai reçu une menace de mort m’annonçant que j’allais être décapitée. J’ai déposé plainte.
https://miniurl.be/r-4zjw — https://twitter.com/mh_thoraval/status/1730327056095781272 »",99,405,0,504
227,1730274528977137926,2023-11-30 17:16:09,NemesisNemesi75,"⚠️Témoignage de Yona, notre militante agressée par le fameux @Toufik2Planoise (Paul Guardado de son vrai nom) qui n’en n’est pas à son premier d’essai et qui aime beaucoup photographier les jeunes femmes sans leur consentement…

➡️Nos militantes portent plainte contre lui https://twitter.com/NemesisNemesi75/status/1730274528977137926/video/1",1252,3361,221,4834
228,1730169470901993611,2023-11-30 10:18:41,NemesisNemesi75,"Boguslaw Glegola a été reconnu coupable de viol et d’agression sexuelle sur une auto-stoppeuse à Lévignacq en 2018. Il encourrait la perpétuité mais la récidive n’a pas été retenue.

Pourtant, son ADN a permis de l’identifier un an plus tard, alors qu’il est en prison en…",47,146,3,196
229,1730144538193235976,2023-11-30 08:39:37,NemesisNemesi75,Nous sommes dans un pays où des hommes condamnés pour agression sexuelle n’écopent que de peines avec sursis probatoire tandis que des hommes qui ont participé à une manifestation illégale à #RomanSurIsere sans faire de dégâts ni de victimes écopent de peines de prison ferme avec… https://twitter.com/NemesisNemesi75/status/1730144538193235976/photo/1,723,1512,32,2267
230,1730141882020204629,2023-11-30 08:29:03,NemesisNemesi75,"""Parce qu’il est jaloux, il a contrôlé le vagin de madame"".

Un comportement ""affligeant"", ""humiliant"", une pratique ""moyenâgeuse"". Voilà comment a été décrit l’acte de cet homme de 46 ans, domicilié à Roanne, par le procureur de la République Abdelkrim Grini.

Un Roannais vient…",89,194,10,293
231,1730138224159248859,2023-11-30 08:14:31,NemesisNemesi75,"Mardi 28 novembre 2023, Baptiste* (nom d’emprunt) a été jugé par le tribunal correctionnel de Caen en son absence pour avoir agressé sexuellement deux mineures. L’une en juillet 2019 à Charencey (Orne), l’autre d’octobre à novembre 2020 à Thury-Harcourt-Le Hom (Calvados).

Il a…",30,77,6,113
232,1730136933773304120,2023-11-30 08:09:24,NemesisNemesi75,"Un commercial de 24 ans condamné à seulement six mois de prison avec sursis probatoire pour avoir agressé sexuellement une femme à son domicile dans le Morbihan.

Il l’a plaquée contre un mur, lui a caressée les fesses et a tenté de glisser une main dans son pantalon.…",61,168,2,231
233,1730134201565868407,2023-11-30 07:58:32,NemesisNemesi75,"Que fait un ressortissant congolais déjà condamné deux fois pour agression sexuelle ? Et bien il recommence une troisième fois bien sur !

Il sera jugé le 20 décembre 2023 par le tribunal de Versailles. L’homme est accusé d’avoir agressé sexuellement une adolescente de 17 ans,…",914,1752,63,2729
234,1729794973183193283,2023-11-29 09:30:34,NemesisNemesi75,"Marseille : Une jeune femme de 18 ans séquestrée et forcée à se prostituer, les policiers la libèrent.

Quatre suspects ont été interpellés et placés en garde à vue: trois hommes de 29, 25, et 22 ans, ainsi qu'une adolescente de 16 ans, ont été arrêtés et conduits au…",685,1414,76,2175
235,1729561674800062735,2023-11-28 18:03:31,NemesisNemesi75,"Vous n’allez pas le croire mais c’est vrai : un homme sud-coréen vient d’être interpellé pour exhibitionnisme dans une résidence étudiante paris. Il était simplement vêtu d’un masque de Zorro.

Ce n’était pas la première fois puisqu’il y sévit depuis 2020.

➡️Exigeons l’expulsion…",103,405,22,530
236,1729557268050350269,2023-11-28 17:46:00,NemesisNemesi75,C’est pas de la discrimination à l’embauche comme vous aimez tant vous en plaindre ça @LiaBzn ? https://twitter.com/NemesisNemesi75/status/1729557268050350269/photo/1,135,472,11,618
237,1729519182046171479,2023-11-28 15:14:40,NemesisNemesi75,"Des électeurs #NUPES poignardent dans nos rues. France, 2023. « sandrousseau: Des fascistes marchent dans nos rues.
France, 2023. — https://twitter.com/sandrousseau/status/1729271059881345029 »",769,3295,19,4083
238,1729503870903058575,2023-11-28 14:13:50,NemesisNemesi75,"En juillet 2021, à Blois, Hachem Tabbah, 71 ans, avait été condamné à six ans d’emprisonnement pour avoir violé l’une de ses patientes, le 17 février 2009. Il avait été relaxé pour des agressions sexuelles dénoncées par une autre plaignante.

L’ex-gynécologue de Vendôme accusé de…",54,168,5,227
239,1728853128353874064,2023-11-26 19:08:00,NemesisNemesi75,"L’une de nos militantes a été intimidée par le militant/journaliste @Toufik2Planoise alors qu’elle collait pour rendre hommage à Thomas. 

Celui-ci a arraché les affiches. La honte. « yona_nms: Voilà comment les militants/journalistes de gauche, arrachent les affiches en hommage à Thomas 16ans, décédé.
N'hésitant pas à intimider les jeunes filles (en infériorité numérique) les ayant collées.
À partager en masse.
#besancon #Thomas https://twitter.com/enfantdefrance7/status/1728844456600969571/video/1 — https://twitter.com/yona_nms/status/1728844456600969571 »",2194,3774,361,6329
240,1728826464106160555,2023-11-26 17:22:03,NemesisNemesi75,"En 2019 et en 2021, nous avons été violemment exclues de la manifestation #noustoutes pour avoir parlé des victimes dont les neo-féministes ne parlent jamais : les victimes de l’immigration massive.

Cette année, ce sont des femmes venues parler des femmes violées par le #Hamas… https://twitter.com/NemesisNemesi75/status/1728826464106160555/photo/1",233,620,17,870
241,1728721975969726487,2023-11-26 10:26:51,NemesisNemesi75,"« ON A ENCORE TROLLÉ NOUS TOUTES 😈 »

L'an dernier, nous avions déjà trollé la manifestation Nous toutes en y venant habillées en niqabs intégraux et en nous revendiquant ""féministes islamistes"". Ce qui n'avait suscité aucune réaction de la part des manifestants et…",177,567,11,755
242,1728712554862563807,2023-11-26 09:49:25,NemesisNemesi75,@Mia_4cents @RevPermanente Ben non vu que c’est pas nous,0,22,1,23
243,1728466063652724878,2023-11-25 17:29:57,NemesisNemesi75,Quelques exemples de vraies pancartes qu’on peut trouver dans les manifestations #NousToutes On comprend mieux pourquoi nos pancartes n’ont pas suscitées de réactions… https://twitter.com/NemesisNemesi75/status/1728466063652724878/photo/1,78,246,18,342
244,1728466055633285205,2023-11-25 17:29:55,NemesisNemesi75,"🤡On a (encore) trollé #NousToutes 🤡

Le Collectif Némésis était présent à la manifestation Nous toutes à Paris ce samedi. 

Cette année, nous sommes venues dénoncer les dérives du féminisme de Nous Toutes. 

Tous les ans, dans cette manifestation, nous voyons des revendications… https://twitter.com/NemesisNemesi75/status/1728466055633285205/photo/1",554,1677,91,2322
245,1728464232864223589,2023-11-25 17:22:41,NemesisNemesi75,"@JulietteBriens La deuxième en fait puisque quand on s’est revendiquées « féministes islamistes » l’année dernière, personne n’a bronché non plus 🥲",14,190,3,207
246,1728455799461036106,2023-11-25 16:49:10,NemesisNemesi75,"Pendant la manifestation #NousToutes des militants antifas et pro-palestiniens de @RevPermanente nous ont confondu avec des manifestantes venues dénoncer les viols commis par le Hamas. On peut les entendre ici vociférer : "" Némésis casse toi » 🤡.

Au delà de la situation qui est… https://twitter.com/NemesisNemesi75/status/1728455799461036106/video/1",404,969,56,1429
247,1728437790830977514,2023-11-25 15:37:36,NemesisNemesi75,"« Sans blancs de rien » , «Si tu es blanc tu es problématique », «À bas les blancs, les flics et les fachos » , «Libérez la sexualité des enfants » Cette année encore nous étions présentes à la manifestation #NousToutes  . 

Cette fois-ci, nous sommes venues avec des pancartes… https://twitter.com/NemesisNemesi75/status/1728437790830977514/video/1",1297,3305,369,4971
248,1728426889507725515,2023-11-25 14:54:17,NemesisNemesi75,"Cette année encore nous étions présentes à la manifestation #NousToutes . 

Cette fois-ci, nous sommes venues avec des pancartes anti-blancs, anti-police, anti-hommes et une appelant à « libérer la sexualité des enfants ». Résultat : aucune réaction de la part des manifestants et… « Livrenoirmedia: 🚨: les manifestants ne semblent avoir aucune réaction face aux pancartes des militantes du collectif @NemesisNemesi75 

#violencessexistesetsexuelles https://twitter.com/Livrenoirmedia/status/1728424740132397133/video/1 — https://twitter.com/livrenoirmedia/status/1728424740132397133 »",520,1418,96,2034
249,1728353456027517091,2023-11-25 10:02:29,NemesisNemesi75,@CocardeEtud Merci 🙏,2,25,1,28
250,1728135831767118314,2023-11-24 19:37:44,NemesisNemesi75,"Notre pays regorge de personnes comme #Alan, le héros français de Dublin.

Malheureusement, il regorge aussi de #Chaid.",248,1286,20,1554
251,1728005106438721854,2023-11-24 10:58:16,NemesisNemesi75,"L’histoire de Fabienne aurait dû faire la une des journaux pendant plusieurs jours. Mais aujourd’hui, ces crimes sont tellement fréquents qu’ils ne sont même plus publiés dans la rubrique des chiens écrasés. 

@libe , au lieu de faire des articles sur nous tous les quatre matins,… https://twitter.com/NemesisNemesi75/status/1728005106438721854/video/1",377,720,9,1106
252,1727981110968156652,2023-11-24 09:22:55,NemesisNemesi75,"Mohamed Zantour a été condamné pour des viols sur sa belle-fille Alicia, 19 ans.
Les viols et agressions sexuelles ont été commis entre ses 9 et 11 ans à Nice.

https://www.nicematin.com/justice/un-beau-pere-condamnepour-viols-aux-assises-a-nice-886486",171,288,5,464
253,1727966490299699340,2023-11-24 08:24:50,NemesisNemesi75,"Après l’Italie, la Hongrie, la Pologne, la Finlande, le Danemark ou encore la Suède, c’est au tour des Pays-Bas de prendre un tournant décisif sur sa politique migratoire après la victoire aux législatives de Geert Wilders. 

Partout en Europe, les peuples rejettent l’immigration…",283,831,18,1132
254,1727952628657656086,2023-11-24 07:29:45,NemesisNemesi75,Source : https://m-sundayworld-com.translate.goog/crime/irish-crime/creche-worker-stabbed-in-horror-dublin-attack-hailed-as-hero-as-girl-5-clings-to-life/a381199576.html?_x_tr_sl=en&_x_tr_tl=fr&_x_tr_hl=fr&_x_tr_pto=wapp,28,106,3,137
255,1727952627441320027,2023-11-24 07:29:44,NemesisNemesi75,"« Elle a défendu ces enfants de toutes ses forces »

À Dublin, une travailleuse éducative âgée d’une trentaine d’années a été saluée comme une héroïne après être intervenue lorsqu’un homme, qualifié par de nombreux internautes irlandais de migrant algérien, a tenté de poignarder…",1023,2748,70,3841
256,1727671517939478902,2023-11-23 12:52:43,NemesisNemesi75,"La fille adoptive d’un ami intime de Gabriel Matzneff accuse l’écrivain de viols et d’agressions sexuelles quand elle était enfant, de ses 4 à 13 ans, dans les années 1980.  Elle n’avait que 4 ans quand les violences sexuelles ont débuté, 13 ans quand elle a subi la dernière…",202,496,24,722
257,1727603316870295667,2023-11-23 08:21:42,NemesisNemesi75,"En 2016, Pascaline Acquart, une Axonaise de 43 ans, mourait dans un accident de la route à Parcy-et-Tigny près de Soissons. Son compagnon, Emmanuel Persin,
est jugé pour meurtre à partir de ce jeudi.

Elle avait été retrouvée éjectée de l’habitacle mais l’autopsie du corps avait…",80,243,8,331
258,1727601484563353605,2023-11-23 08:14:25,NemesisNemesi75,"Une plainte pour viols a été déposée à l'encontre de l'animateur vedette de NRJ Sébastien Cauet, déjà accusé depuis plusieurs semaines d'avoir envoyé des messages à caractère sexuel à une mineure, poussant NRJ Group à retirer de manière ""temporaire"" l'animateur de ses antennes…",55,168,8,231
259,1727415137999687861,2023-11-22 19:53:57,NemesisNemesi75,"Vous n’avez pas honte @prefetrhone ?
« Crevez en silence les Français » voilà ce que nous ressentons à l’annonce de cette info.

#Thomas #Crepol « prefetrhone: Face aux tentatives de récupération, aux slogans xénophobes et provocations à la haine susceptibles d'être prononcés, mais aussi aux risques de confrontations violentes, le rassemblement prévu ce soir à 19h00 à Lyon 5e est interdit par arrêté préfectoral. https://twitter.com/prefetrhone/status/1727361441014186080/photo/1 — https://twitter.com/prefetrhone/status/1727361441014186080 »",1154,2777,74,4005
260,1727328155604553938,2023-11-22 14:08:19,NemesisNemesi75,"« Seuls les citoyens suédois ont un droit inconditionnel de résider en Suède»

a déclaré de son côté aux journalistes Ludvig Aspling, porte-parole des SD chargé des questions migratoires.

Le gouvernement suédois a annoncé, mardi, vouloir imposer aux migrants de s'engager à vivre…",523,1370,23,1916
261,1727252558220058791,2023-11-22 09:07:55,NemesisNemesi75,"[TÉMOIGNAGE] : Une employée d’un tribunal administratif travaillant dans une chambre spécialisée dans les obligations de quitter le territoire français nous a confié son témoignage.

Elle nous parle du rôle des associations pro-migrants comme @forumrefugies dans la procédure pour… https://twitter.com/NemesisNemesi75/status/1727252558220058791/video/1",253,417,10,680
262,1727046657911423052,2023-11-21 19:29:44,NemesisNemesi75,"Aliou Coundoul, un Sénégalais en situation irrégulière vient d’être condamné à 25 ans pour le meurtre
d‘Amélie Amar en 2021.

Il avait tué son ex-compagne de 59 coups de couteau avant de prendre des photos du corps et de les envoyer aux proches de la victime. 

Les avocats… https://twitter.com/NemesisNemesi75/status/1727046657911423052/photo/1",794,1639,239,2672
263,1727023969415696491,2023-11-21 17:59:35,NemesisNemesi75,@Zaraoustra7820 @CordierAlice2 Montre nous donc ta tête de « droitard à l’ancienne »,0,13,0,13
264,1726907898931142797,2023-11-21 10:18:22,NemesisNemesi75,"Encore une fois les publicitaires n’osent pas mettre de la diversité dans leurs spots de prévention. Et ils préfèrent donc rendre responsable « Severine » , la femme blanche, des incivilités dans le métro.

Quel sketch @GroupeSNCF,  @RATPgroup, @IDFmobilites … https://twitter.com/NemesisNemesi75/status/1726907898931142797/photo/1",462,1313,73,1848
265,1726901784583823488,2023-11-21 09:54:04,NemesisNemesi75,"@CharlesAncelot @lelapindufutur C’est la vidéo du @lelapindufutur , pas de @RebeuDeter .Tant mieux si ça lui fait des vues.",22,492,3,517
266,1726891514452664635,2023-11-21 09:13:15,NemesisNemesi75,"Le @lelapindufutur a réalisé une vidéo 
sur la scandaleuse émission du youtubeur Billal Hakkar, plus connu sous le nom de  @RebeuDeter.

Dans l’une de ses émissions, celui-ci a invité un certain Jassim, un jeune Maghrébin. Celui-ci a expliqué comment, pour ne pas avoir a passer… https://twitter.com/NemesisNemesi75/status/1726891514452664635/photo/1",1863,3453,118,5434
267,1726655694068150469,2023-11-20 17:36:11,NemesisNemesi75,"« Les plus gros complices, si j’ose dire, c’est les avocats : ils sont rémunérés via l’aide juridictionnelle. C’est une énorme source de revenus pour eux, puisque, quand on est entre 5 et 15 OQTF contestées par jour, c’est eux qui vont récupérer environ 600 euros par affaire »… https://twitter.com/NemesisNemesi75/status/1726655694068150469/video/1",1180,1740,41,2961
268,1726628858341023803,2023-11-20 15:49:33,NemesisNemesi75,"Vivement votre une spéciale « NUPES : leurre des femmes » @libe. Parce que franchement on a encore jamais vu mieux en terme d’hypocrisie envers les femmes et de sabotage de leurs droits. « libe: 🔴 RN : leurre des femmes.

C'est la une de @Libe ce lundi

Lire : http://journal.liberation.fr https://twitter.com/libe/status/1726327383412674966/photo/1 — https://twitter.com/libe/status/1726327383412674966 »",30,117,3,150
269,1726611435466141960,2023-11-20 14:40:19,NemesisNemesi75,"Mercredi 15 novembre à Mers-les-Bains, une femme de 58 ans a été retrouvée morte, le corps couvert de traces de coups.

Le suspect est son compagnon, un homme de 73 ans qui avait interdiction de contact suite à des violences conjugales.

Il a été mis en examen ce vendredi.…",46,125,6,177
270,1726610010791112845,2023-11-20 14:34:40,NemesisNemesi75,"Rudy Carlin comparaît cette semaine devant la cour d'assises de la Marne. Abordant un couple d'étudiants sous le faux prétexte de trouver de la drogue un soir, il avait assassiné le jeune homme et violé la jeune femme en 2021.

Le quadragénaire toxicomane aux 30 mentions sur son… https://twitter.com/NemesisNemesi75/status/1726610010791112845/photo/1",154,309,30,493
271,1726608778076778757,2023-11-20 14:29:46,NemesisNemesi75,"Un fait qui illustre particulièrement bien la lenteur de notre justice. Et en attendant le jugement, les victimes peuvent recroiser leurs agresseurs mêmes si ceux-ci ont en théorie interdiction de rentrer en contact avec la victime:

À Aire-sur-l’Adour, trois adolescents de âgés…",67,221,6,294
272,1726548103766135090,2023-11-20 10:28:40,NemesisNemesi75,"L’article a quand même l’intérêt de parler d’une action récente que l’une de nos militantes a réalisé récemment lors d’une rencontre avec @RoyalSegolene . À revoir ici ⬇️ « CordierAlice2: 🔴 NOTRE MILITANTE INTERPELLE SÉGOLÈNE ROYAL 🔴

Lors de la dédicace de son nouvel ouvrage « Refusez la cruauté du monde ! Le temps d’aimer est venu », une de nos militantes a décidé d’interpeller l’ancienne ministre de la famille et de l’éducation sur sa responsabilité en terme… https://twitter.com/CordierAlice2/status/1721994860301787553/video/1 — https://twitter.com/cordieralice2/status/1721994860301787553 »",13,47,1,61
273,1726548100053950759,2023-11-20 10:28:39,NemesisNemesi75,"Sinon, une fois n’est pas coutume, nous faisons encore l’objet de l’attention du torchon @libe grâce à nos meilleurs publicitaires que sont @pierre_plottu et Maxime Macé. Ils seraient au chômage sans nous.

L’article avance que nous serions une création de l’extrême-droite à la… « pierre_plottu: Comment l'extrême droite se sert des femmes comme vitrine, tout en continuant à promouvoir un machisme rétrograde 
[coprod @MaskymMace]
https://www.liberation.fr/politique/les-influenceuses-identitaires-des-clics-et-des-reacs-20231119_AYXQU3ZL4BAQVOFFAGWJ5E6SNA/ — https://twitter.com/pierre_plottu/status/1726494234377699453 »",76,307,10,393
274,1726543248553070631,2023-11-20 10:09:22,NemesisNemesi75,On a trouvé la fameuse mère Noëlle de #Nantes : https://twitter.com/NemesisNemesi75/status/1726543248553070631/photo/1,53,340,25,418
275,1726538385156677992,2023-11-20 09:50:03,NemesisNemesi75,"Nous sommes une association contre les violences faites aux femmes. N’étant pas un parti politique, c’est le combat que nous avons décidé de mener en priorité. 

Mais nous avons aussi des fils, des pères, des maris et des frères. Et nous ne pouvons que pleurer #Thomas tué à… https://twitter.com/NemesisNemesi75/status/1726538385156677992/photo/1",1643,5436,112,7191
276,1726178935430349109,2023-11-19 10:01:43,NemesisNemesi75,"« Il y a des personnes sous OQTF qui ne doutent de rien. On a vu des violeurs d’enfants récidivistes qui sont venus contester leurs OQTF devant la justice »

[TÉMOIGNAGE] : Une employée d'un tribunal administratif travaillant dans une chambre spécialisée dans les obligations de… https://twitter.com/NemesisNemesi75/status/1726178935430349109/video/1",1508,2296,68,3872
277,1726149131503067450,2023-11-19 08:03:17,NemesisNemesi75,@Luturon 🤣🤣🤣,0,1,0,1
278,1726147097798295645,2023-11-19 07:55:13,NemesisNemesi75,"Ce sous-titre existe :
#Guerriau https://twitter.com/NemesisNemesi75/status/1726147097798295645/photo/1",21,163,12,196
279,1726143134344925582,2023-11-19 07:39:28,NemesisNemesi75,"À Agen : une jeudi 16 novembre, un Marocain en situation irrégulière a agressé sexuellement une adolescente.

 Il a notamment tripoté, caressé, et embrassé la victime. Il a été interpellé.

https://actu.fr/nouvelle-aquitaine/agen_47001/agen-une-adolescente-victime-dune-agression-sexuelle-a-la-gare_60352519.html",200,429,34,663
280,1725956170941083722,2023-11-18 19:16:32,NemesisNemesi75,"Étonnant que dans tous les tweets de @GDarmanin s’enorgueillissant d’avoir expulsé des étrangers illégaux, il ne précise jamais dans quel pays. Seulement « pays d’origine ». 

Quels sont ces pays @GDarmanin ? 

En 2022, 65 076 OQTF ont été prononcées. En 2021 c’était 124 111.

À… « GDarmanin: [THREAD]
 
Hier, Vendredi 17 Novembre, 15 étrangers délinquants ont été renvoyés du territoire national. Parmi eux : 

👉A.K., 25 ans, connu des services de police pour agression au couteau, usage de drogue, vol avec violence, vol avec arme et violation de domicile. Placé au… — https://twitter.com/gdarmanin/status/1725850415667814530 »",276,727,19,1022
281,1725794253052248380,2023-11-18 08:33:08,NemesisNemesi75,"""En face de moi, j’avais le diable. Un cannibale""

Sandrine a vécu un calvaire le 28 juillet 2021 quand elle a croisé Saeed Gul Miagul, un réfugié afghan arrivé en France en 2017. 

Reconnu par Sandrine, confondu par son ADN, le mis en cause dit avec l’aide de son interprète ne…",1319,2511,185,4015
282,1725462867351130368,2023-11-17 10:36:19,NemesisNemesi75,"C’est fou comme les langues se délient une fois que les ex-responsables comme @MarleneSchiappa sont écartés du pouvoir. 🤡 « F_Desouche: Marlène Schiappa : « Quand j’ai fait passer la loi sur le harcèlement de rue, les opposants virulents n’étaient pas des réactionnaires voulant conserver le droit à importuner, mais des collectifs féministes intersectionnels ayant peur que cela stigmatise les ""racisés"" » https://twitter.com/F_Desouche/status/1725283572225896804/video/1 — https://twitter.com/f_desouche/status/1725283572225896804 »",670,1897,25,2592
283,1725457997042794532,2023-11-17 10:16:58,NemesisNemesi75,"À Marseille, une association féministe , le @lilithCEL s’est vu couper ses subventions par la mairie. 

La raison ? Une transphobie supposée.

L’association qui depuis 33 ans milite entre autres contre la prostitution et la GPA est régulièrement menacée par les associations…",91,247,18,356
284,1725453962780782673,2023-11-17 10:00:56,NemesisNemesi75,"⚠️Les étrangers deux fois plus représentés que les français dans les mis en cause pour violences conjugales
 en 2022⚠️

➡️17% des personnes mis en cause pour violences conjugales enregistrées en 2022 par les services de sécurité sont des étrangers.

➡️Selon le dernier rapport de… https://twitter.com/NemesisNemesi75/status/1725453962780782673/photo/1",181,333,13,527
285,1725451075791016258,2023-11-17 09:49:28,NemesisNemesi75,"Après avoir été hospitalisée trois mois #Mégane a pu rentrer chez elle. 

La jeune cherbourgeoise, victime d'Oumar Ndiaye en août dernier, suit désormais ""une rééducation fatigante"" selon sa famille.

https://www.francebleu.fr/infos/faits-divers-justice/viol-barbare-a-cherbourg-megane-est-sortie-de-l-hopital-apres-trois-mois-au-service-reanimation-7452190",319,835,43,1197
286,1725445897872462109,2023-11-17 09:28:53,NemesisNemesi75,"« Est-ce qu’en Seine-Saint-Denis on a le même rapport aux femmes que dans le reste de la France ? On peut se questionner là-dessus. »

@CordierAlice2 était l’invitée hier soir de @JPasquet sur @CNEWS pour parler notamment des derniers chiffres des violences conjugales en France… https://twitter.com/NemesisNemesi75/status/1725445897872462109/video/1",363,841,23,1227
287,1725234012241711153,2023-11-16 19:26:56,NemesisNemesi75,"Le sénateur de 66 ans Joël Guerriau a été placé en garde à vue ce jeudi. Il est soupçonné d'avoir drogué une députée en vue d'une agression sexuelle. 

Banquier de profession, élu à la Haute Assemblée depuis 2011, Joël Guerriau est secrétaire du Sénat et vice-président de la… https://twitter.com/NemesisNemesi75/status/1725234012241711153/photo/1",355,594,58,1007
288,1725174793257775184,2023-11-16 15:31:37,NemesisNemesi75,"Alors qu’elle est payée avec de l’argent public en tant qu’actrice du premier navet de Mehdi Fikri, @Camelia_Jordana  se sent « blacklistée ». 

Nous sommes une association contre les violences faites aux femmes qui, contrairement à toutes les autres n’a jamais touché un centime… « franceinter: ""Quand vous êtes perçue comme une parfaite image de l'intégration et que, du jour au lendemain, vous êtes blacklistée, pointée du doigt, c'est extrêmement violent.""

Camélia Jordana revient sur les réactions à ses propos sur le racisme et les violences policières. 

#le710inter https://twitter.com/franceinter/status/1724689714177884411/video/1 — https://twitter.com/franceinter/status/1724689714177884411 »",419,1524,71,2014
289,1725148510176125245,2023-11-16 13:47:11,NemesisNemesi75,"⚠️ Cette année encore, l’association la @lacimade connue pour aider des migrants délinquants et criminels à rester sur notre territoire en les aidant à contester leurs OQTF, organise dans plus de 100 villes en France les festivals « Migrant’Scène » du 16 novembre au 9 décembre… https://twitter.com/NemesisNemesi75/status/1725148510176125245/photo/1",231,392,25,648
290,1725129097620168940,2023-11-16 12:30:02,NemesisNemesi75,"À Rennes, Exose Mangai Menayame, un Congolais de 21 ans écope de 2 ans de prison et 10 ans d’interdiction de territoire français pour avoir agressé sexuellement 6 femmes. L’une des victimes a été prise à la gorge et menacée avec un cutter.

Pour sa défense, l’accusé a évoqué “un… https://twitter.com/NemesisNemesi75/status/1725129097620168940/photo/1",1007,1773,238,3018
291,1725104157621666283,2023-11-16 10:50:56,NemesisNemesi75,"Le ministère de l’Intérieur de @GDarmanin annonce 15% d’augmentation de plaintes pour violences conjugales en 2022.                

Les victimes sont majoritairement des femmes et seulement 1 victime sur 4 porterait plainte.  

Les régions les plus touchées par ce fléau sont :… https://twitter.com/NemesisNemesi75/status/1725104157621666283/photo/1",76,155,9,240
292,1724827001784094936,2023-11-15 16:29:37,NemesisNemesi75,"Merci à @mbockcote sur @CNEWS pour avoir cité @CordierAlice2 , présidente de notre association, au sujet des nouvelles mesures de sécurité que doivent prendre les femmes dans la nouvelle France Orange mécanique https://twitter.com/NemesisNemesi75/status/1724827001784094936/video/1",228,631,2,861
293,1724761521803170124,2023-11-15 12:09:25,NemesisNemesi75,"Aymen N., vient d’être placé en détention provisoire :

Le 1er novembre dernier, une femme a porté plainte pour un viol commis par cet individu qu’elle avait rencontré sur le réseau social musulman « Muzz ».

Il lui aurait imposé une fellation et l’aurait agressé sexuellement.…",202,507,22,731
294,1724757992497684756,2023-11-15 11:55:24,NemesisNemesi75,"Que pouvons-nous dire à part « Bravo » à @JulietteBriens pour cette leçon magistrale face à #Moundir ? « JulietteBriens: Merci pour tous vos messages.  

Moundir a pris une sacré rouste. 

Sur la fesse gauche et sur la fesse droite. — https://twitter.com/juliettebriens/status/1724526035939582189 »",207,1080,11,1298
295,1724469834677645354,2023-11-14 16:50:22,NemesisNemesi75,"Un homme de 37 ans soupçonné d'avoir agressé sexuellement une femme de 87 ans  à l'hôpital Bel-Air de Thionville (Moselle), dans la nuit de lundi à mardi, a été placé en garde à vue.

https://actu17.fr/faits-divers/thionville-un-homme-soupconne-davoir-agresse-sexuellement-une-femme-de-87-ans-a-lhopital.html",139,276,16,431
296,1724359493213892664,2023-11-14 09:31:54,NemesisNemesi75,"Fouad S. est jugé à partir de ce mardi et pendant deux semaines, pour l’enlèvement et la séquestration de deux de ses 4 enfants de 5 et 7 ans, le 7 juillet 2020 à Drancy. Il avait enlevé ses enfants dans des sacs de sport, trimbalés comme du linge sale.

L’homme n’en était pas à… https://twitter.com/NemesisNemesi75/status/1724359493213892664/photo/1",133,237,7,377
297,1724355869674987621,2023-11-14 09:17:30,NemesisNemesi75,"Dimanche 12 novembre à Nice, deux Tunisiens 🇹🇳 en situation irrégulière ont agressé une femme à la sortie du tramway. Celle-ci a été gravement blessée par plusieurs coups de «cutter» au niveau de la gorge. 

https://www.lefigaro.fr/nice/nice-une-femme-agressee-au-cutter-a-la-sortie-du-tramway-20231113",405,564,25,994
298,1724354564437028894,2023-11-14 09:12:19,NemesisNemesi75,"À ce jour, les islamistes tolèrent le fait que les femmes musulmanes voilées fassent leur propagande sur les RS, mais leur projet est ensuite de leur enlever ce droit, puis d’autres.

Dans les pays aux mains des islamistes, cela se passe toujours de la même façon :

⁃demander… https://twitter.com/NemesisNemesi75/status/1724354564437028894/video/1",627,1284,112,2023
299,1724353028663259368,2023-11-14 09:06:13,NemesisNemesi75,"Frapper sa femme est ressortir libre dans l’attente de son procès alors qu’on a été interpellé avec de l’héroïne et qu’on est récidiviste ? 

C’est ce qu’il se passe quotidiennement en France avec la justice actuelle de @E_DupondM dont le chef du gouvernement @EmmanuelMacron…",216,524,19,759
300,1724070615458398216,2023-11-13 14:24:01,NemesisNemesi75,"⚠️Petit bilan sur une semaine des victimes qui auraient pu ne pas en être sans l’immigration incontrôlée :

Le 11 novembre : un migrant centrafricain est interpellé pour le viol d’une une femme sous la menace d'un couteau et d’avoir tenté d’en violer une seconde sur les…",541,1111,19,1671
301,1724068493585207424,2023-11-13 14:15:35,NemesisNemesi75,@Davidch58585882 @kamilabderrahmn ce reportage date de 2015,1,4,0,5
302,1724062695261864142,2023-11-13 13:52:32,NemesisNemesi75,@Cbr100062 Source de ces 80% ?,1,3,2,6
303,1724062614290944399,2023-11-13 13:52:13,NemesisNemesi75,@AJ0261794663167 Source de cette affirmation ? Tous les sondages prouvent le contraire,0,5,1,6
304,1724062306449924331,2023-11-13 13:51:00,NemesisNemesi75,"Nous voulons être sûres d’avoir bien compris. Tu es vraiment entrain d’essayer de nous expliquer que des femmes voilées se font agresser et/ou insulter en masse en zone « blanche rurale » @kamilabderrahmn ? « kamilabderrahmn: Je propose à cette propagatrice de haine anti musulmans @ELevyCauseur de refaire ce test en caméra cachée en portant une kippa en banlieues et en zone banche rurale et refaire le même test avec une femme qui porte le voile, on va voir qui sont les racistes https://twitter.com/kamilabderrahmn/status/1724018709159641430/video/1 — https://twitter.com/kamilabderrahmn/status/1724018709159641430 »",96,584,20,700
305,1724006664104272248,2023-11-13 10:09:53,NemesisNemesi75,"Près de 7 femmes françaises sur 10 pensent qu’il y a trop d’immigrés extra-européens en France.

Les femmes questionnées sur le sujet sont légèrement plus nombreuses (67 %) que les hommes (65 %) à juger que la France comptait trop d’immigrés ne provenant pas du Vieux Continent.… https://twitter.com/NemesisNemesi75/status/1724006664104272248/photo/1",108,355,17,480
306,1723999213623599283,2023-11-13 09:40:17,NemesisNemesi75,"#13Novembre2015

En ce jour, toutes nos pensées accompagnent les victimes, les familles des victimes et les orphelins. 47 ne diront plus jamais papa, 20 ne diront plus jamais maman, Et 2 ne diront plus jamais ni maman, ni papa. https://twitter.com/NemesisNemesi75/status/1723999213623599283/photo/1",150,441,4,595
307,1723996585573401013,2023-11-13 09:29:50,NemesisNemesi75,"Après les 130 morts et les 413 blessés du  #13Novembre 2015, il s’en est suivi des « plus jamais ça » puis des « pas de récupération politique ». 

Nous avons dit « Plus jamais ça » mais rien n’a été fait. Et notre pays n’a jamais connu autant d’attentats islamistes depuis : 

-… https://twitter.com/NemesisNemesi75/status/1723996585573401013/photo/1",1032,2062,52,3146
308,1723984904264769745,2023-11-13 08:43:25,NemesisNemesi75,"«Pour ma femme et moi, il nous semble que l’Etat français devrait assumer ses responsabilités. Qu’est ce qui n’a pas été fait pour que ces attentats se produisent sans difficultés particulières ?»

C’est la question que se pose Jean-Bernard Arruebo, père d'Anne-Laure Arruebo,… https://twitter.com/NemesisNemesi75/status/1723984904264769745/photo/1",161,445,6,612
309,1722919396270551115,2023-11-10 10:09:29,NemesisNemesi75,"« Y’a rien qui bouge. Ça fait 6 ans et en 6 ans y’a rien eu de mis en place. Moi je veux du concret je veux que ça change, que ça ne de reproduise pas. Que des personnes qui ne doivent pas être sur le territoire ne soient pas sur le territoire ».

La mère de Laura, tuée avec sa… https://twitter.com/NemesisNemesi75/status/1722919396270551115/video/1",704,1597,26,2327
310,1722915222095020042,2023-11-10 09:52:53,NemesisNemesi75,@MaanymalM25380 Oui « grâce » aux aménagements et aux remises de peine de notre chère justice française.,13,91,1,105
311,1722913511938892037,2023-11-10 09:46:06,NemesisNemesi75,"Condamné à 30 ans de réclusion pour le meurtre de sa première femme en 2004, il était pourtant déjà dehors en 2018:

Maxène Toussaint, un haïtien de 39 ans déjà condamné pour l’assassinat de sa femme en 2004, tente de tuer sa nouvelle compagne en 2018. 

Soit à peine 14 ans après…",449,838,30,1317
312,1722911801195499797,2023-11-10 09:39:18,NemesisNemesi75,"""Je t'ai ramenée ici pour la cuisine et pour le sexe !"" (…) ""Elle carbonisait (les plats), elle le faisait exprès"".

Ce sont les mots de Youcef, qui vient d’être condamné à 10 ans pour viol conjugal sur Samia, une Marocaine ne parlant pas le français.

L’individu avait déjà été…",646,1449,63,2158
313,1722899202185805940,2023-11-10 08:49:14,NemesisNemesi75,"Un homme de 32 ans déjà défavorablement connu de la justice a frappé à plusieurs reprises une enseignante d’école primaire de Tomblaine, près de Nancy ce jeudi 9 novembre.

L’individu, qui s'est avéré être le père d'une élève de cette école, était en train de filmer des écoliers…",221,496,18,735
314,1722672631608963273,2023-11-09 17:48:55,NemesisNemesi75,"https://twitter.com/NemesisNemesi75/status/1722672631608963273/video/1 « ArnaultRaphael: 🚨Le Groupe Antifasciste Lyon et Environs vient d’être dissous par le gouvernement. Le même qui tend la main depuis des mois à l’extrême-droite et ajd prêt à manifester avec un parti fondé par des nazis.

Va falloir être fort dans la période, ça va secouer. — https://twitter.com/arnaultraphael/status/1722611887891009769 »",43,335,0,378
315,1722566122879225923,2023-11-09 10:45:42,NemesisNemesi75,Vous êtes désormais plus de 50 000 abonnés à nous suivre sur @X ! Merci 🤩 🎉 https://twitter.com/NemesisNemesi75/status/1722566122879225923/video/1,75,401,18,494
316,1722538304795468140,2023-11-09 08:55:09,NemesisNemesi75,"Un homme étranger de 45 ans en situation irrégulière interpellé pour le meurtre de sa conjointe, une femme âgée de 80 ans. 

Mercredi 8 novembre 2023, dans le faubourg de Figuerolles-Chaptal elle a été retrouvée morte, poignardée à mort.

Le suspect qui était « en quête de…",478,861,48,1387
317,1722535951690330558,2023-11-09 08:45:48,NemesisNemesi75,"Mohamed Boutadiz a été condamné ce mercredi 8 novembre 2023 à dix-huit ans de réclusion criminelle par la cour d’assises de la Gironde au terme de trois jours d’audience.

Il a été reconnu coupable du viol d’une adolescente sous la menace d’une arme, le 20 juin 2020, à Bordeaux.…",486,1069,42,1597
318,1722209057308877111,2023-11-08 11:06:51,NemesisNemesi75,"Sources : 

https://ville-data.com/delinquance/Lyon-69-69123

https://tribunedelyon.fr/politique/gregory-doucet-refuse-dinstaller-des-cameras-la-region-retire-sa-subvention/

et 

https://www.bfmtv.com/amp/lyon/la-guillotiere-mazagran-cameras-gregory-doucet-defend-son-bilan-en-matiere-de-securite-a-lyon_AV-202306150885.html",27,89,0,116
319,1722209053714374677,2023-11-08 11:06:50,NemesisNemesi75,"BIENVENUE À #LYON !

➡️où le nombre de plaintes pour violences sexuelles a augmenté de 21,4 % en 2022

➡️où les forces de Police et de Gendarmerie ont enregistré 50 931 crimes et délits en 2022 contre 48 284 en 2021, soit une hausse de 5,5 % en un an.

➡️où le nombre de plaintes… https://twitter.com/NemesisNemesi75/status/1722209053714374677/photo/1",1691,3587,101,5379
320,1722190022328172619,2023-11-08 09:51:12,NemesisNemesi75,"@Toufik2Planoise Ça c’est du journalisme d’investigation 🤓 Vous ne vous sentez pas trop mal d’être la dame pipi en chef de la Franche-Comté ?  Pas trop dur de passer ses journées à faire le même travail que les collabos ? 

Vous allez faire un post à chaque stickers ou tracts distribués par…",80,682,5,767
321,1722184560174055717,2023-11-08 09:29:30,NemesisNemesi75,"Castres : un clandestin tunisien sous OQTF agresse deux jeunes filles et les traite de “sales putes”.

L’agresseur alcoolisé a aussi jeté sur des policiers une bouteille de bière qui s’est brisée au sol, puis s’est avancé vers les tessons, menaçant, en criant « Allah Akbar et…",207,451,24,682
322,1722183454979199202,2023-11-08 09:25:06,NemesisNemesi75,"À #Nantes, une réceptionniste de 44 ans d’un hôtel Appart'City porte plainte pour viol et séquestration. L’individu qui lui a aussi demandé la caisse s’est fait passer pour un client.

Les faits se seraient déroulés entre 2h et 6h du matin, rue Emile Masson, à 500m de la gare.…",208,472,24,704
323,1722181955863589273,2023-11-08 09:19:09,NemesisNemesi75,Merci à @mbockcote pour son édito sur @CNEWS hier soir concernant la fermeture injuste et arbitraire de notre compte en banque. https://twitter.com/NemesisNemesi75/status/1722181955863589273/video/1,398,923,14,1335
324,1721899492272926768,2023-11-07 14:36:44,NemesisNemesi75,"En laissant venir toujours plus d’hommes venant de pays qui voilent, excisent et lapident leurs femmes @sandrousseau ? « sandrousseau: L’avenir politique à gauche sera féministe ou ne sera pas. — https://twitter.com/sandrousseau/status/1721800575090561477 »",491,1916,35,2442
325,1721853653231812873,2023-11-07 11:34:36,NemesisNemesi75,"La femme et la fille de Ian Foster, le sélectionneur des All Blacks ont été agressées par un homme armé d’un couteau à Créteil pendant la coupe du monde de rugby. Des faits rapportés par la presse néo-zélandaise.

Après les faits, les joueurs comme leur entourage ont été…",271,695,19,985
326,1721843531533131838,2023-11-07 10:54:22,NemesisNemesi75,"⚠️Un clandestin afghan aidé par des associations d’aide aux migrants interpellé pour le viol d’une joggeuse fin août à Fréjus dans le Var ⚠️. 

L'auteur présumé du viol est également connu outre-Rhin, pour des faits d'agressions sexuelles. Il a été confondu grâce à son empreinte…",845,1511,61,2417
327,1721482254705098794,2023-11-06 10:58:47,NemesisNemesi75,"Nous avons rarement lu le récit d’une affaire aussi sordide. Une affaire qui selon l’un des avocats des victimes «balaie toutes les horreurs du droit pénal »: 

Julien (prénom modifié) un homme de 34 ans sera jugé toute la semaine à Grenoble pour avoir notamment violé deux de ses…",408,852,98,1358
328,1721426095403045242,2023-11-06 07:15:38,NemesisNemesi75,"« Elle m’a provoqué » explique au tribunal Mohammed, 23 ans condamné pour agression sexuelle dans le tramway de Saint-Etienne. En mai 2022, il avait notamment «donné un coup sur la cuisse avec son pénis» à une jeune fille.

https://www.leprogres.fr/faits-divers-justice/2023/11/06/il-avait-tape-avec-son-sexe-la-cuisse-d-une-passagere-du-tram",206,444,23,673
329,1721419722518863943,2023-11-06 06:50:18,NemesisNemesi75,"Un Ehpad des Alpes-Maritimes ferait pression sur la famille d’une dame âgée de 93 ans. La famille accuse un veilleur de nuit de cet Ehpad d’avoir violé la nonagénaire.

Malgré une plainte déposée en 2022, l’homme est toujours employé par l’établissement. Et la famille assure…",643,1034,32,1709
330,1720737890714448144,2023-11-04 09:40:57,NemesisNemesi75,"«On souhaite montrer qu’à Saint-Jean-de-Monts, on ne se laissera pas faire  (…) Des habitants demandent des logements sociaux depuis des années et n’y ont pas droit»

Dans la commune de Saint-Jean-de-Monts en Vendée, le collectif «Rassemblement Vendéen» annonce la tenue d’un…",763,2045,50,2858
331,1720722904965406861,2023-11-04 08:41:24,NemesisNemesi75,"Mehdi, un chauffeur VTC en situation irrégulière interpellé pour l’agression sexuelle d’une passagère.

La plaignante, âgée de 27 ans, explique avoir constaté la présence du conducteur nu dans son lit à son réveil chez elle, à Boulogne-Billancourt, dans la nuit de mardi à…",523,1083,48,1654
332,1720524074525380832,2023-11-03 19:31:19,NemesisNemesi75,@GWGoldnadel Les deux font la paire 🙃,5,127,5,137
333,1720467743911080334,2023-11-03 15:47:29,NemesisNemesi75,@cdeprick Nous avouons: nous avons ri,0,20,0,20
334,1720437053261856982,2023-11-03 13:45:32,NemesisNemesi75,"À Lyon, la police recherchait depuis un peu plus de quatre mois un individu pour viol :  un Guinéen vient d’être interpellé pour ces faits.

Le 22 juin dernier, une jeune femme coréenne avait déposé plainte pour un viol particulièrement violent en pleine rue. Elle avait été…",442,872,25,1339
335,1720434501971521692,2023-11-03 13:35:24,NemesisNemesi75,"Une lycéenne de 15 ans a été battue et violée le samedi 7 octobre dans la petite commune d'Ornolac-Ussat-les-Bains en Ariège. L’adolescente a accepté de monter dans la voiture de l’agresseur après que celui-ci ai lourdement insisté pour l’accompagner dans la commune voisine.

Le…",629,1037,55,1721
336,1720358990591226102,2023-11-03 08:35:20,NemesisNemesi75,"@flanker8783 @radiocourtoisie @CordierAlice2 Revoyez la définition stricto sensu du mot identitaire : 

Être identitaire c’est tout simplement considérer que notre identité est aujourd’hui menacée. Et elle l’est évidemment aujourd’hui. Cela ne signifie en aucun cas de dire qu’il n’y a aucun problème sans l’immigration et…",1,2,1,4
337,1720355032632082830,2023-11-03 08:19:37,NemesisNemesi75,"Qu’est-ce qui fait qu’une étudiante en art ait voulu créer un mouvement féministe identitaire ? 

La réponse avec Charlotte, responsable de la communication du Collectif Némésis dans l’émission « Question(s) d’engagement » sur @radiocourtoisie avec @CordierAlice2.

➡️ À écouter… https://twitter.com/NemesisNemesi75/status/1720355032632082830/video/1",52,147,2,201
338,1720035431444521225,2023-11-02 11:09:38,NemesisNemesi75,"À Riom un clandestin afghan de 31 ans qui était particulièrement agressif avec des jeunes femmes dans un TER est maîtrisé par un jeune policier en formation. 

En situation irrégulière, l’Afghan a ensuite été remis à la police aux frontières en vue de son placement dans un centre…",471,1339,47,1857
339,1719961579586789567,2023-11-02 06:16:10,NemesisNemesi75,"À Nîmes, deux jeunes femmes ont pourchassé et neutralisé un migrant malien de 22 ans qui venait de voler le portable d’une victime sourde et muette.

Puis, elles ont appelé les policiers qui l’ont arrêté.

A l’arrivée des forces de l’ordre, le suspect s’est rebellé lors de son…",1231,4094,245,5570
340,1719284551984267424,2023-10-31 09:25:54,NemesisNemesi75,"Nordahl Lelandais de nouveau devant la justice pour répondre de faits d'agressions sexuelles sur mineure et menace de mort. 

Il s'agirait de sa toute première victime. Une petite cousine âgée de 14 ans qu'il aurait agressée sexuellement et menacé de mort avant le meurtre de la…",150,364,15,529
341,1719253853957140638,2023-10-31 07:23:55,NemesisNemesi75,"Guiliana B., une femme de 37 ans a été retrouvée morte, lardée d’une vingtaine de coups de couteau. Son compagnon Lionel W, 52 ans, aurait succombé à un seul coup de couteau en plein cœur. Le couple était en pleine séparation. À ce stade les enquêteurs explorent toutes les pistes…",84,237,7,328
342,1719006349671997800,2023-10-30 15:00:26,NemesisNemesi75,"À Sèvres dans les Hauts-de-Seine, une femme a vécu l’horreur dans la nuit du samedi 28 au dimanche 29 octobre : 

vers 2h du matin, alors qu’elle quittait son logement pour se rendre au travail, elle a été surprise par un individu qui a surgi dans son dos en pleine rue.

Cet…",462,853,30,1345
343,1719005166978879804,2023-10-30 14:55:44,NemesisNemesi75,@WhiteLady1113 Nous ne disons pas qu’il n’y a pas de problèmes spécifiques pour les femmes dans certains milieux particulièrement masculins à un certain niveau. Nous disons qu’il y a beaucoup moins de femmes programmeuses ou réalisatrices parce qu’elles se dirigent moins vers ses métiers-là.…,2,12,4,18
344,1718998424459059670,2023-10-30 14:28:56,NemesisNemesi75,"Le 25 octobre 2023, Nina Métayer est devenue la première femme à remporter le prestigieux titre mondial de meilleur pâtissier de l'année.

Elle avait déjà été distinguée deux années de suite en tant que meilleure pâtissière de l’année en France.

Une femme inspirante qui a su se… https://twitter.com/NemesisNemesi75/status/1718998424459059670/photo/1",209,868,20,1097
345,1718955414551728349,2023-10-30 11:38:02,NemesisNemesi75,"Dans beaucoup de domaines, des féministes se plaignent que les femmes et leurs point de vue soient sous-représentés : le cinéma, les jeux vidéo, la politique…

Ce changement ne se fera pas en geignant : faites des études dans ces domaines, investissez-les, devenez réalisatrice,… https://twitter.com/NemesisNemesi75/status/1718955414551728349/video/1",94,521,48,663
346,1718947652946039163,2023-10-30 11:07:11,NemesisNemesi75,"Geoffrey, un Calaisien de 42 ans condamné pour avoir agressé sexuellement Lola* (prénom modifié) sa fille de 12 ans à Antibes entre juin 2022 et juin 2023. 

Il comparaissait libre au tribunal. Le prévenu a été condamné à 3 ans de prison entièrement assorti d’un sursis probatoire…",199,411,25,635
347,1718934266296311913,2023-10-30 10:13:59,NemesisNemesi75,"⚠️Une grande première en France⚠️ : 

L’État condamné pour ""dysfonctionnement du service public de la justice"", dans l’affaire du meurtre d'Ahlam Sehili, tuée par son mari Faouzi Idoudi le 17 avril 2010 qui s’est défenestré ensuite.

La veille du meurtre, un policier avait refusé… https://twitter.com/NemesisNemesi75/status/1718934266296311913/photo/1",285,924,19,1228
348,1718887494375100573,2023-10-30 07:08:08,NemesisNemesi75,"À Toulouse, une femme de 27 ans a porté plainte pour un viol après une soirée en boîte de nuit le 15 octobre 2023. Elle a expliqué aux policiers avoir écrasé le suspect avec sa voiture. 

Quelques jours plus tard, ce dernier s’est présenté à la gendarmerie pour déposer une…",575,2035,61,2671
349,1717888108279062556,2023-10-27 12:56:56,NemesisNemesi75,"VICTOIRE ! Notre compte @PayPal fonctionne de nouveau. 

Le service client @AskPayPal nous a assuré qu’il s’agissait d’une simple erreur informatique. Nous allons partir du principe qu’ils sont de bonne foi et les remercions pour leur réactivité. 

Merci à tous pour votre…",333,1445,38,1816
350,1717872161644323194,2023-10-27 11:53:34,NemesisNemesi75,"La France Maghreb mécanique épisode 183838293 :

« J’ai vu la photo de la victime, c’est absolument abominable. Une horreur. J’en ai vu des agressions, mais celle-là j’avais jamais vu, (…) C’est la France Orange mécanique » 

confie un policier chevronné à propos de l’agression…",1235,2448,118,3801
351,1717800648371032101,2023-10-27 07:09:24,NemesisNemesi75,"Quid des 25% d’étrangers qui occupent les prisons françaises ? 

Des 700 000 clandestins actuellement sur notre territoire que vous avez comptabilisé en 2021 ? Et des 100 000 supplémentaires minimum qui rentre chaque année ? Qu’est-il mis en œuvre pour que S.M ne revienne jamais… « GDarmanin: S.M., 39 ans, étranger en situation régulière qui était activement suivi par les services de renseignement en raison de sa radicalisation s’est vu retirer son titre de séjour et a été expulsé hier, conformément à mes instructions de grande fermeté.

https://www.lefigaro.fr/faits-divers/un-delinquant-fiche-s-expulse-vers-le-maghreb-sur-instruction-ministerielle-20231026 — https://twitter.com/gdarmanin/status/1717527175799185629 »",229,531,12,772
352,1717558951384887791,2023-10-26 15:08:59,NemesisNemesi75,"Drame en 3 actes:

En 2021, lors d’un débat sur le port du voile, notre présidente @CordierAlice2 interpellait le rappeur Brulux dans l’émission @TPMP de @Cyrilhanouna. 

Dans ce débat, le rappeur Brulux, de son vrai nom Hedi Chabar, lui ordonnait de « porter le voile ». 

En… https://twitter.com/NemesisNemesi75/status/1717558951384887791/video/1",1789,3682,193,5664
353,1717469574583443883,2023-10-26 09:13:50,NemesisNemesi75,@AskPayPal Nous vous avons contacté en MP.,15,165,8,188
354,1717465271026209267,2023-10-26 08:56:44,NemesisNemesi75,"Notre compte @PayPal vient d’être clôturé sans aucune raison.

Malgré de nombreux appels au service client @AskPayPal @PayPalFrance, la standardiste a évoqué une « décision venant d’en haut » , qui n’avait pas « été prise à la légère » sans expliquer les motifs de cette fameuse…",849,1806,126,2781
355,1717117363621941481,2023-10-25 09:54:16,NemesisNemesi75,"Nous venons d’apprendre une information SCANDALEUSE : 

Champion (sic), 27 ans, l’un des mis en examen, pour le meurtre de Patrice Lanies, lors des Fêtes de Bayonne le 26 juillet dernier aurait dû être en prison.

En effet, celui-ci avait été condamné en 2021 pour VIOL EN RÉUNION…",1789,3279,120,5188
356,1716798053007364210,2023-10-24 12:45:27,NemesisNemesi75,@Orodorada Ce qui ne change absolument rien au fait que nous n’avons jamais demandé la fermeture d’un lieu de culte 🤡,0,19,2,21
357,1716796382663623023,2023-10-24 12:38:48,NemesisNemesi75,@Orodorada Nous n’avons pas porté de Burqa à Lille et n’avons absolument jamais demandé la fermeture de lieux de culte mais c’est pas grave. Vous avez l’air de ne pas avoir tout suivi.,0,26,1,27
358,1716794345137832382,2023-10-24 12:30:43,NemesisNemesi75,Rappelons d’ailleurs qu’ @Utopia_56 s’était déjà illustrée en demandant à leurs bénévoles féminines de ne pas venir en jupe ou en décolleté pour travailler au contact des migrants pour « respecter la différence culturelle ».⬇️ https://twitter.com/NemesisNemesi75/status/1716794345137832382/photo/1,179,332,10,521
359,1716794337164415177,2023-10-24 12:30:41,NemesisNemesi75,"En avril dernier, des militantes du Collectif Némésis se sont rendues à l’école Erlanger dans le XVIeme arrondissement de Paris, squattée par l’association @Utopia_56 qui y logeait illégalement plusieurs centaines de migrants soi-disant mineurs.

À cette occasion, des militants… « NemesisNemesi75: 🛑🛑Samedi 15 avril, nos militantes ont été agressées par des bénévoles de l’association @Utopia_56. 

➡️Notre vidéo pour comprendre notre action et aussi ce qui se cache derrière l’association @Utopia_56 : 

https://youtu.be/IqKfuw-jnLo https://twitter.com/NemesisNemesi75/status/1648751874797961217/video/1 — https://twitter.com/nemesisnemesi75/status/1648751874797961217 »",1086,2000,41,3127
360,1716792840179658975,2023-10-24 12:24:44,NemesisNemesi75,@Orodorada Mais de quelles actions parlez-vous ?,0,13,1,14
361,1716780145900454290,2023-10-24 11:34:17,NemesisNemesi75,"@NicolasMeu1 @Le_Malabar_du25 À part votre intuition, qui vous dit que la victime n’est pas elle-même indienne ?",0,1,0,1
362,1716779690751328401,2023-10-24 11:32:29,NemesisNemesi75,@WhiteLady1113 @agent_p3rry Non visiblement ils ne savent pas 🤷🏻‍♀️,1,1,1,3
363,1716779399335301404,2023-10-24 11:31:19,NemesisNemesi75,@Orodorada Une action respectable c’est seulement quand l’accusé a un nom et prénom français c’est ça ? On a le droit de pointer du doigt l’agresseur seulement si celui-ci s’appelle Olivier Bailly mais pas quand il s’appelle Oumar Ndiaye ?,52,321,5,378
364,1716754452219117951,2023-10-24 09:52:11,NemesisNemesi75,"Il y a un an, des militantes dijonnaises se sont rendues place Darcy et porte Guillaume, afin d’alerter sur la peine ridiculement faible dont a écopé Olivier Bailly, ex-juge au tribunal judiciaire de Dijon.

Ce vice-président du tribunal judiciaire de Dijon au moment des faits,… https://twitter.com/NemesisNemesi75/status/1716754452219117951/photo/1",713,1403,47,2163
365,1716745945583419437,2023-10-24 09:18:23,NemesisNemesi75,"Une femme suisse 🇨🇭 a été retrouvée morte vendredi dans un sac poubelle à Delhi en Inde 🇮🇳.

L’auteur du crime est un Indien qui s’était vu refuser une demande en mariage par sa victime. 

Les deux s’étaient rencontrés sur Internet en 2021 sur la plateforme de vidéos en direct… https://twitter.com/NemesisNemesi75/status/1716745945583419437/photo/1",546,1163,76,1785
366,1716329948275699924,2023-10-23 05:45:22,NemesisNemesi75,"L’animateur Vincent Cerutti mis en examen pour agression sexuelle après avoir mordu les fesses d'une collaboratrice. Les faits, qui remontent à 2015, avaient provoqué la mise à pied puis le départ anticipé de l’animateur de Chérie FM, en 2017. 

https://www.leparisien.fr/culture-loisirs/tv/lanimateur-vincent-cerutti-mis-en-examen-pour-avoir-mordu-les-fesses-dune-collaboratrice-20-10-2023-AWFZP25IQJEMVEAAMCKM7SFKNA.php?ts=1697821751148",40,158,15,213
367,1716329161319411804,2023-10-23 05:42:14,NemesisNemesi75,"Mohamed Guittouni condamné à 20 ans de réclusion pour avoir violé Geraldine, une étudiante en médecine.

https://www.nicematin.com/justice/assises-peine-confirmee-pour-le-viol-d-une-etudiante-marseillaise-880806",132,393,13,538
368,1716327850737868837,2023-10-23 05:37:02,NemesisNemesi75,"Moussa Boune condamné à 6 ans seulement pour viol . En octobre 2019, à Auray, il a violé une jeune femme de sa connaissance. 

https://www.ouest-france.fr/bretagne/morbihan/morbihan-six-ans-de-prison-pour-viol-e0ca581a-6f50-11ee-a00f-d55111ba52f2",132,260,12,404
369,1716023937564385430,2023-10-22 09:29:23,NemesisNemesi75,"""LES FRANÇAISES NE SONT PAS DES FRONTIÈRES VIOLABLES "" 

C’est ce que nous avons souhaité dire ce dimanche pendant la célèbre course @runinfrance à #Lyon en recouvrant de messages le parcours de la course.

Pendant cette course, l'association pro-migrants KABUBU (@kabubu_org)… https://twitter.com/NemesisNemesi75/status/1716023937564385430/video/1",1048,2899,65,4012
370,1715640562651480253,2023-10-21 08:05:59,NemesisNemesi75,"« C’est la première erreur que je fais depuis quatre semaines que je suis en France. » explique Ramazan, un clandestin irakien jugé pour l’agression sexuelle de Kamelia, une petite fille de 12 ans dans une piscine à Dunkerque.

La justice devrait plutôt décerner une médaille à ce…",1277,3297,179,4753
371,1715432753506709531,2023-10-20 18:20:14,NemesisNemesi75,@DamienRieu @alexiscorbiere @RaquelGarridoFr @Le_CRIF @PoliceNationale @prefpolice @GWGoldnadel @Meyer_Habib Ses parents @RaquelGarridoFr et @alexiscorbiere lui ont transmis de belles valeurs républicaines et humanistes visiblement…,292,2768,23,3083
372,1715423188845302081,2023-10-20 17:42:13,NemesisNemesi75,"Jean-Baptiste M., l’homme interpellé mercredi pour le meurtre de la petite #Loana, était un voisin de la victime et connaissait ses parents. Il vient d’avoué l’avoir violée.

Le mis en cause n’a pas reconnu le meurtre. Il a évoqué  « un accident », affirmant que la fillette était… https://twitter.com/NemesisNemesi75/status/1715423188845302081/photo/1",1160,2648,237,4045
373,1715332352447045984,2023-10-20 11:41:16,NemesisNemesi75,"Avec ce visuel choquant mais malheureusement réaliste, nous souhaitons alerter sur les nombreux viols et agressions sexuelles qui ont eu lieu sur le Champ-de-Mars.

Nous souhaitons qu’ @Anne_Hidalgo, la maire de Paris ainsi que @datirachida, la maire du 7ème arrondissement de… https://twitter.com/NemesisNemesi75/status/1715332352447045984/photo/1",3564,6735,191,10490
374,1715280128861753398,2023-10-20 08:13:45,NemesisNemesi75,"Le corps de Loana, une fillette de 10 ans disparue depuis mardi soir, a été retrouvé mercredi soir dans la cave d’un appartement de Sedan (Ardennes). Jean-Baptiste M., un homme de 57 ans a été interpellé. 

https://www.leparisien.fr/faits-divers/sedan-un-corps-retrouve-dans-un-appartement-apres-la-disparition-dune-fillette-de-10-ans-19-10-2023-QUIHLYLFXNGOLHK3UU4SJGJFIA.php",128,329,25,482
375,1715267558087995604,2023-10-20 07:23:48,NemesisNemesi75,"Nantes : un homme guinéen de 18 ans, en situation irrégulière sur le territoire, est suspecté de trois tentatives de viol, sur des femmes  faisant leurs jogging. 

https://www.lefigaro.fr/nantes/tentatives-de-viol-sur-des-joggeuses-a-nantes-un-jeune-de-18-ans-en-detention-provisoire-20231019",300,471,23,794
376,1715241784228344154,2023-10-20 05:41:23,NemesisNemesi75,@PaduStream On veut bien parler du QI des droitardés mais par contre tu as mis le drapeau du Soudan 🇸🇩 sur ta vignette de vidéo censée parler de la Palestine 🇵🇸 .,10,142,11,163
377,1714986571215024548,2023-10-19 12:47:16,NemesisNemesi75,@EdouardCouchiu @CordierAlice2 @ArnaultRaphael @milafique Merci ! Que vous ont-ils répondu ?,1,9,1,11
378,1714974438490345806,2023-10-19 11:59:03,NemesisNemesi75,"⚠️Chers abonnés, nous avons besoin de VOUS.⚠️

Il y a quelques jours notre présidente @CordierAlice2 a été menacée de mort par @ArnaultRaphael d’une balle dans la tête lors d’un rassemblement en hommage à Dominique Bernard. @milafique a été agressé par ce même individu. Cette… https://twitter.com/NemesisNemesi75/status/1714974438490345806/photo/1",643,1087,41,1771
379,1714967926594269393,2023-10-19 11:33:10,NemesisNemesi75,"Ce dimanche, un chasseur a découvert le corps d'une femme dans la Marne. L'enquête doit établir s'il s'agit de Madison Collot, une jeune femme de 24 ans, portée disparue depuis la semaine dernière.

Le corps a été retrouvé flottant sur un plan d'eau. L’intervention d'une personne… https://twitter.com/NemesisNemesi75/status/1714967926594269393/photo/1",649,1137,52,1838
380,1714666355994071509,2023-10-18 15:34:50,NemesisNemesi75,"Ça alors comme c’est bizarre !

En septembre dernier, 3 de nos militantes partaient en GAV pour avoir déployé une banderole alertant sur les lectures salafistes dans le lycée musulman Averroès de Lille. 
La maire de la ville @MartineAubry a aussi porté plainte contre nous pour «…",1458,3654,130,5242
381,1714658930813501481,2023-10-18 15:05:20,NemesisNemesi75,"⚠️Mise à jour concernant cette affaire⚠️:

Samir B., a été REMIS EN LIBERTÉ sous contrôle judiciaire alors qu’il est soupçonné d’avoir agressé sexuellement deux femmes de 93 et 95 ans. L’une des victimes est décédée quelques heures plus tard.

Il est convoqué devant le tribunal… « NemesisNemesi75: ⚠️ Samir B., un homme de 44 ans, a été interpellé pour des agressions sexuelles sur deux femmes âgées de 93 et 95 ans dans la chambre d’un service de gériatrie du Val-d’Oise⚠️

L'une d'entre elle, atteinte de troubles psychologiques, est morte après une suspicion de viol. Selon… — https://twitter.com/nemesisnemesi75/status/1713857850970161588 »",813,1544,88,2445
382,1714564124921716783,2023-10-18 08:48:37,NemesisNemesi75,"Un Syrien a agressé sans raison trois femmes et une fillette en pleine rue à Tignes vendredi 13 octobre.

Ces dernières ont été mises à terre par un inconnu qui les avait saisies par les cheveux. Il a également caillassé et menacé les gendarmes. 

➡️Seulement 1 an de prison…",750,1296,61,2107
383,1714562380162609217,2023-10-18 08:41:41,NemesisNemesi75,"Paris : Une jeune femme violemment agressée à la sortie de son travail par un homme armé d'un couteau de cuisine de 25 cm. Celui-ci avait le visage dissimulé et les mains gantées et il l’a rouée de coups.

Placé en garde à vue au, l'agresseur a déclaré qu'il avait tenté de…",891,1776,46,2713
384,1714331860552044658,2023-10-17 17:25:40,NemesisNemesi75,"L’Institut de La Boétie, un think tank officiel de la @FranceInsoumise dont @JLMelenchon est le président organise un atelier avec le leader de la @jeune_garde antifasciste @ArnaultRaphael. 

Nous rappelons à cet institut que celui-ci vient d’agresser @milafique , une victime de… « i_laboetie: « Groupuscules d'extrême droite : implantation, idéologie, formation »

Assistez notre l'atelier avec @MatMolard, rédacteur en chef de @streetpress et @ArnaultRaphael, porte-parole de la Jeune Garde.

👉 Inscrivez-vous au colloque : https://actionpopulaire.fr/formulaires/colloque-extremedroite-ilb-21102023/ https://twitter.com/i_laboetie/status/1714305133306155459/photo/1 — https://twitter.com/i_laboetie/status/1714305133306155459 »",232,433,17,682
385,1714252969028276307,2023-10-17 12:12:11,NemesisNemesi75,"@ArnaultRaphael Sans tes camarades Dominique Bernard serait encore en vie. 

Et tu as eu en plus le culot de menacer à ce rassemblement Mila, une victime des islamistes qui a eu une cible sur sa tête et qui a dû vivre sous protection policière ? Comment fais-tu pour te regarder dans une glace ?…",266,1873,24,2163
386,1714224229107794000,2023-10-17 10:17:59,NemesisNemesi75,"Pour rappel, @ArnaultRaphael c’est aussi celui qui se cache derrière une poubelle dans cette vidéo de la manif #NousToutes du 20 novembre 2021 alors que la @jeune_garde agressait nos militantes 🤡: 

Vidéo à voir en entier ici:

https://youtu.be/ova5jbEuAFI?si=H3rPntUP1wWRpIuo https://twitter.com/NemesisNemesi75/status/1714224229107794000/video/1",480,709,37,1226
387,1714212893778981017,2023-10-17 09:32:57,NemesisNemesi75,"Celui qui a agressée et menacée hier en pleine commémoration pour le professeur Dominique Bernard @milafique et qui a menacé de mort @CordierAlice2 n’est autre que @ArnaultRaphael , leader du groupe antifasciste violent la @jeune_garde.

Ce mouvement est connu pour avoir, entre… « milafique: C’est lui qui m’a agressé et menacée hier soir, Raphael Arnault Leader de la jeune garde. Lui qui a menacé de mettre une balle dans la tête de Alice Cordier pendant le rassemblement pour Dominique Bernard. https://twitter.com/milafique/status/1714208088071295416/photo/1 — https://twitter.com/milafique/status/1714208088071295416 »",1437,2533,145,4115
388,1714194630940430617,2023-10-17 08:20:22,NemesisNemesi75,"La Tour Eiffel et à ses pieds le Champ-de-Mars font rêver les touristes du monde entier. Pourtant, depuis quelques temps, il ne s’y passe pas un mois sans qu’une femme n’y soit violée ou agressée sexuellement. 

Ces joyaux de la capitale sont devenus une honte pour notre pays.…",550,1319,41,1910
389,1714182138705150326,2023-10-17 07:30:44,NemesisNemesi75,"Encore une fois, sans l’immigration extra-européenne, deux personnes européennes seraient encore en vie ce matin. 

Encore une fois, Abdesalem Lassoued 45 ans, le terroriste de Daech de l’attentat de #Bruxelles est un migrant illégal tunisien.

Encore une fois, il était déjà… https://twitter.com/NemesisNemesi75/status/1714182138705150326/photo/1",976,2814,84,3874
390,1713998190465159298,2023-10-16 19:19:47,NemesisNemesi75,@backupmyspare @milafique Tu es visiblement totalement attardé vu qu’on ne fait que ça toute la journée. Il suffit de regarder notre fil aujourd’hui.,18,442,6,466
391,1713992356926550407,2023-10-16 18:56:36,NemesisNemesi75,"Mila s’est rendue à une commémoration à Lyon en hommage à Dominique Bernard, le professeur assassiné à #Arras par Mohammed Mogouchkov. Elle a été insultée par plusieurs antifas. 

@milafique a pu enregistrer une partie de la conversation : son agresseur menace de mort notre… https://twitter.com/NemesisNemesi75/status/1713992356926550407/video/1",1210,2046,106,3362
392,1713976357590290647,2023-10-16 17:53:02,NemesisNemesi75,"Soutien à @milafique agressée par des gauchistes à une commémoration en hommage à Dominique Bernard, le professeur assassiné à #Arras par Mohammed Mogouchkov.

Les mêmes qui empêchent les expulsions de ce genre d’individus organisent ensuite des hommages pour les victimes de leur… « milafique: Je n’avais pas capté que c’était un syndic de gauche qui organisait ça, je suis venue sans même me poser de questions. 
Pour moi, c’était un moment qui permettait à tout le monde de se rassembler autour de la victime pour le soutenir, avant même de revendiquer ses idéologies. — https://twitter.com/milafique/status/1713972854197301543 »",352,996,13,1361
393,1713915754846851451,2023-10-16 13:52:13,NemesisNemesi75,"L’homme d’affaires Gilbert Greaux a été interpellé le 25 septembre 2023 à Port Sainte-Lucie en Floride. 

Il était recherché depuis 2018, après avoir fui sa condamnation en France outre-Atlantique en 2015 pour plusieurs viols et 14 agressions sexuelles entre octobre 2013 et…",134,323,2,459
394,1713857850970161588,2023-10-16 10:02:08,NemesisNemesi75,"⚠️ Samir B., un homme de 44 ans, a été interpellé pour des agressions sexuelles sur deux femmes âgées de 93 et 95 ans dans la chambre d’un service de gériatrie du Val-d’Oise⚠️

L'une d'entre elle, atteinte de troubles psychologiques, est morte après une suspicion de viol. Selon…",939,1716,132,2787
395,1713804098418381124,2023-10-16 06:28:32,NemesisNemesi75,"Encore une affaire de viol correctionnalisé et qui est requalifiée en simple agression sexuelle:

Un homme de 53 ans qui voulait assouvir « un fantasme à l'aide de margarine » a été déclaré coupable d'agression sexuelle par le tribunal de Saint-Malo, jeudi 12 octobre 2023. 
Il a…",503,1131,33,1667
396,1713800265961202042,2023-10-16 06:13:18,NemesisNemesi75,"Jean-Noël Dagnicourt, un homme de 61 ans est condamné à dix-huit ans de réclusion, avec une période de sûreté de douze ans
pour le viol d’une jeune femme en 2020 à Caen.

Il avait déjà été condamné pour viol en 1999. La victime a mis fin à ses jours quelques mois avant le procès.…",124,315,9,448
397,1713798844150870191,2023-10-16 06:07:39,NemesisNemesi75,"Après le PDG d’Assu 2000, son directeur général Amir Messadi à son tour visé par une plainte pour viols: 

La plaignante dénonce avoir été victime de harcèlement sexuel dès son arrivée au sein de la société, en août 2021, puis avoir subi quatre viols.

Amir Messadi lui aurait…",147,304,3,454
398,1713608486301368534,2023-10-15 17:31:15,NemesisNemesi75,@PirouetteZamani Elles ne sont bien évidemment jamais milliardaires.,1,42,0,43
399,1713576896661774530,2023-10-15 15:25:43,NemesisNemesi75,"Félicitations, la mère va pouvoir retourner dans les tréfonds de la précarité maintenant. « 2dadsParis: Très heureux de vous présenter Louis né le 11 octobre 2023 à Sacramento à 34 semaines. 
Louis et la surrogate vont biens. 
Séjour d’une ou deux semaines en neonat pour s’assurer qu’il grandisse bien ! 
#gpa #surrogacy #lgbtfamilies https://twitter.com/2dadsParis/status/1713061925708517397/photo/1 — https://twitter.com/2dadsparis/status/1713061925708517397 »",260,1512,129,1901
400,1713442538915307866,2023-10-15 06:31:50,NemesisNemesi75,"Monsieur @GDarmanin , votre gouvernement est celui qui a le plus utilisé le 49.3 depuis Mitterand en l’appliquant plus d’une dizaine de fois. Ne prenez pas les Français pour des imbéciles en nous faisant croire que dans ce cas précis vous ne pouvez rien faire. « BFMTV: Gérald Darmanin: ""Il y a 4000 étrangers délinquants que je ne peux pas expulser du territoire national parce que la loi empêche de les expulser"" https://twitter.com/BFMTV/status/1713241300617638029/video/1 — https://twitter.com/bfmtv/status/1713241300617638029 »",369,930,16,1315
401,1713439344546009534,2023-10-15 06:19:08,NemesisNemesi75,"Une femme politique est menacée pour avoir fait respecter la loi et l’ordre dans sa ville :

Sonia Brau, maire UDI de @Saintcyrlecole reçoit régulièrement des menaces de mort et sa voiture a été brûlée ce jeudi.

Vendredi 13 octobre, des tags menaçants ont également été…",1023,2070,93,3186
402,1713099165322838473,2023-10-14 07:47:23,NemesisNemesi75,@Juchelugh Exactement.,4,46,0,50
403,1713097902107578462,2023-10-14 07:42:22,NemesisNemesi75,"Aujourd’hui, nos militantes lilloises se sont rendues à la préfecture du Nord pour rendre hommage à Lola Daviet.

Il y a un an, #Lola, 12 ans, a été tuée et violée de la manière la plus barbare possible par Dahbia Benkired, une Algérienne de 24 ans sous obligation de quitter le… https://twitter.com/NemesisNemesi75/status/1713097902107578462/photo/1",1257,3237,74,4568
404,1712880381920206848,2023-10-13 17:18:01,NemesisNemesi75,"@ArnaultRaphael C’est vrai qu’en matière de violence pour faire taire l’opposition , toi et ton groupe la Jeune Garde vous vous y connaissez… Quand aux « forces réactionnaires » quelle pirouette sémantique pour ne pas parler de terrorisme islamique",25,337,3,365
405,1712841290952343585,2023-10-13 14:42:41,NemesisNemesi75,"Il y a un mois, trois de nos militantes dont notre présidente @CordierAlice2, ont passé une nuit en garde à vue pour avoir notamment demandé à @GDarmanin où en était l’application des #OQTF. 

Aujourd’hui, nous apprenons que Mohammed Mogouchkov, le terroriste d’#Arras, et sa… https://twitter.com/NemesisNemesi75/status/1712841290952343585/photo/1",1537,3116,85,4738
406,1712836566463164793,2023-10-13 14:23:55,NemesisNemesi75,@Cath_RN95 Nous en avions déjà parlé plusieurs fois à l’epoque (cette vidéo a plus d’un an),2,6,1,9
407,1712752744132456909,2023-10-13 08:50:50,NemesisNemesi75,"Le mineur isolé qui avait agressé sexuellement une fillette de 6 ans à Roanne en août 2023 et dont le père avait ensuite été condamné à 8 mois de prison avec sursis pour s’être fait justice lui-même a récidivé sur une éducatrice :

« Il reconnaît les faits et explique qu’il n’a…",2176,3714,424,6314
408,1712748873486053552,2023-10-13 08:35:27,NemesisNemesi75,"Claude O, a été écroué pour le meurtre de Severine B.

Dimanche 1er octobre, le corps sans vie de Séverine B., 46 ans, a été découvert dans sa voiture. Elle avait reçu de très nombreux coups de couteau.

Le suspect a reconnu les faits.

Selon une amie de la victime qui s'exprime… https://twitter.com/NemesisNemesi75/status/1712748873486053552/photo/1",61,191,2,254
409,1712443815850643669,2023-10-12 12:23:16,NemesisNemesi75,@ELISE232425 @partiel6 Si on avait l’adresse de résidence nous la donnerions…,3,19,2,24
410,1712364306413547874,2023-10-12 07:07:19,NemesisNemesi75,"@Anne_Hidalgo @UKhurelsukh Bonjour @Anne_Hidalgo , est-il normal que Majdi Bejaoui, un violeur récidiviste soit logé dans une résidence parisienne? Il faut mettre fin à cette situation insupportable pour ses deux victimes mineures.

« NemesisNemesi75: Nous apprenons qu’un certain Majdi Bejaoui, un violeur récidiviste, est logé en résidence étudiante dans le XIXeme arrondissement de Paris. Nous apprenons en plus qu’il s’est radicalisé en prison. 

Cette information nous est absolument INSUPPORTABLE et nous vous demandons à… — https://x.com/nemesisnemesi75/status/1712362748972077135 »",115,251,3,369
411,1712362748972077135,2023-10-12 07:01:08,NemesisNemesi75,"Nous apprenons qu’un certain Majdi Bejaoui, un violeur récidiviste, est logé en résidence étudiante dans le XIXeme arrondissement de Paris. Nous apprenons en plus qu’il s’est radicalisé en prison. 

Cette information nous est absolument INSUPPORTABLE et nous vous demandons à…",2819,5391,209,8419
412,1712035768149938312,2023-10-11 09:21:49,NemesisNemesi75,"Sources:

https://www.planning-familial.org/sites/default/files/2023-05/PLANNING%20FAMILIAL-Plan-vfinale-DIGITAL.pdf

https://www.marianne.net/societe/un-planning-familial-ramene-le-port-du-voile-un-signe-de-modestie-et-refuse-de-condamner-l

https://www.ladepeche.fr/2020/12/28/personnes-qui-ont-un-uterus-tomber-enceinte-colere-contre-le-planning-familial-9282046.php

@leplanning",32,84,2,118
413,1712035635463164392,2023-10-11 09:21:18,NemesisNemesi75,"Le Planning familial nous vise dans son dernier plan stratégique: la célèbre association s’inquiète de notre implantation en France et nous qualifie de « louves qui essayent de rentrer dans la place ».

Alors oui, nous serons des LOUVES. 
Nous serons les louves du féminisme,… https://twitter.com/NemesisNemesi75/status/1712035635463164392/photo/1",809,2216,124,3149
414,1711743622398234710,2023-10-10 14:00:56,NemesisNemesi75,"Ichem Saghour reconnu coupable du viol de Salomé, une jeune femme de 19 ans le 6 juin 2019.

https://www.lavoixdunord.fr/1382077/article/2023-10-06/viol-salome-ichem-saghour-reconnu-coupable-et-condamne-treize-ans-de-prison",152,260,7,419
415,1711644373119619221,2023-10-10 07:26:34,NemesisNemesi75,"Un Tunisien de 44 ans jugé par la cour d'Assises de Caen (Calvados), lundi 9 et mardi 10 octobre 2023, pour le viol d'une jeune femme italienne commis en 2019.

Son ADN match avec une autre affaire d’agression sexuelle commise sur une autre jeune femme, le 31 octobre 2019, après…",514,868,34,1416
416,1711641195825218036,2023-10-10 07:13:56,NemesisNemesi75,"Ali F. et Daouda B., les auteurs d'un viol filmé en direct dans une cage d'escalier à Morsang-sur-Orge en Essonne en décembre 2019 sont jugés aux assises pour mineurs depuis ce mardi.

Âgés de 16 ans au moment des faits, les deux hommes sont accusés d’avoir violé une jeune femme… https://twitter.com/NemesisNemesi75/status/1711641195825218036/photo/1",2560,4375,745,7680
417,1711489332937171122,2023-10-09 21:10:29,NemesisNemesi75,@MarteauOlivier @EL_PalpitoS Notre réponse est aussi intelligente que votre affirmation débile qui sort d’on ne sait d´où,1,9,2,12
418,1711473417176695247,2023-10-09 20:07:14,NemesisNemesi75,@MarteauOlivier @EL_PalpitoS Nous servons des intérêts extérieurs non-français ? Première nouvelle. Vous êtes marteau 🙃,1,11,1,13
419,1711386449419874562,2023-10-09 14:21:40,NemesisNemesi75,@DbleFace Croyez bien que s’il existait une vidéo ou des soldats israéliens trainaient le corps nu d’une femme en riant nous en parlerions tout autant.,96,1145,42,1283
420,1711381366997127429,2023-10-09 14:01:28,NemesisNemesi75,"Le Collectif Némésis n’a pas vocation à se positionner sur des conflits géopolitiques comme le conflit israélo-palestinien. Ce n’est pas son rôle.

Mais quand des femmes se retrouvent nues et que leurs cadavres sont trainés aux cris de « Allah Akbar », qu’elles sont violées et…",1495,5093,128,6716
421,1711375178926616785,2023-10-09 13:36:53,NemesisNemesi75,"Les survivants de l'attaque du Hamas contre le festival de musique ont été interviewés par @tabletmag :

""Des femmes ont été violées sur le lieu de la rave à côté des corps de leurs amis, des cadavres.

« Plusieurs de ces victimes de viol semblent avoir été exécutées par la… « visegrad24: Survivors of the Hamas attack on the music festival have been interviewed by @tabletmag:

""Women were raped at the area of the rave next to their friends bodies, dead bodies.

""Several of these rape victims appear to have been later executed.” https://twitter.com/visegrad24/status/1711170044036530484/photo/1 — https://twitter.com/visegrad24/status/1711170044036530484 »",1462,2160,197,3819
422,1711369309371441464,2023-10-09 13:13:33,NemesisNemesi75,"⚠️RAPPEL NÉCESSAIRE ⚠️ : la France ne doit pas accueillir de Palestiniens. 

Quelques exemples parmi beaucoup d’autres de ce que font déjà subir des ressortissants palestiniens aux femmes en Europe. 

merci à @F_Desouche https://twitter.com/NemesisNemesi75/status/1711369309371441464/photo/1",537,1077,24,1638
423,1711302654503120977,2023-10-09 08:48:41,NemesisNemesi75,@AJulien23 Malgré le fait d’attendre et d’enlever le lien amp ca ne fonctionne qu’une fois sur deux. Nous ne comprenons pas pourquoi,2,22,1,25
424,1711301373030011107,2023-10-09 08:43:36,NemesisNemesi75,"🇩🇿One, two, three Viva l’Algérie 🇩🇿: à Paris vendredi 6 octobre, une supportrice de l’équipe italienne de rugby agressée sexuellement dans le métro par un Algérien de 32 ans en situation irrégulière. 

Il a frotté son sexe contre elle, à travers son pantalon, à plusieurs…",588,1369,75,2032
425,1711299696537350344,2023-10-09 08:36:56,NemesisNemesi75,"« Moi chercher niquer toi ».

C’est ce qu’a dit (entre autres choses), un Libyen ayant obtenu le statut de réfugié en France à une jeune femme de 16 ans dans le train qu’elle prenait pour aller à l’école. 

La jeune femme a eu le réflexe de filmer cette scène de harcèlement…",1001,2181,91,3273
426,1711293505031545334,2023-10-09 08:12:20,NemesisNemesi75,"Une femme pompier qui portait de secours à un SDF a été la victime de mains aux fesses de la part de l’homme qu’elle aidait. Le mis en cause se serait également caressé le sexe en regardant la femme.

Le groupement de pompiers de Vendée a annoncé avoir porté plainte, tout comme…",169,393,10,572
427,1711291085236969925,2023-10-09 08:02:43,NemesisNemesi75,"Un ressortissant algérien de 19 ans condamné à 18 mois de prison ferme seulement  pour trois agressions sexuelles commises sur des jeunes femmes en Moselle. Des faits que l’intéressé, sous le coup d’une OQTF a nié.

Le mis en cause a tenté d'embrasser de force l'une des jeunes…",454,885,32,1371
428,1711262637621739568,2023-10-09 06:09:41,NemesisNemesi75,"Un Tunisien d’une trentaine d’années en situation irrégulière condamné à 4 ans de prison pour avoir agressé une mineure de 15 ans en juillet 2021. Il est mis en cause dans une affaire similaire.

https://www.lavoixdunord.fr/1381918/article/2023-10-07/fouquieres-les-bethune-reconnu-coupable-d-agression-sexuelle-sur-une-adolescente",198,314,7,519
429,1710992334660256029,2023-10-08 12:15:35,NemesisNemesi75,alors*,7,44,0,51
430,1710991554276442535,2023-10-08 12:12:29,NemesisNemesi75,"La gauche nous parle de « racisme systémique », de «violences policières systémiques », alord que la seule chose SYSTÉMIQUE en France c’est que, quand une vidéo sort sur les RS et où une femme se fait copieusement insulter, c’est systématiquement des hommes issus de l’immigration…",270,1170,23,1463
431,1710987676671783343,2023-10-08 11:57:05,NemesisNemesi75,"« Sur la Mecque j’ai envie de te n*quer ta mère. Wallah sur le Coran. Ta grand-mère la p*te. Raciste, va voter le Pen sale blanche ».

Nous espérons que cette dame suivra les conseils avisés de ce charmant jeune homme et qu’elle ira, en effet, ""voter @MLP_officiel "". https://twitter.com/NemesisNemesi75/status/1710987676671783343/video/1",1644,4195,458,6297
432,1710259020940849228,2023-10-06 11:41:40,NemesisNemesi75,"🎀 #OctobreRose c’est l’occasion de s’informer mais le cancer du sein, il faut y penser toute l’année :

C’est le cancer le plus fréquent en France et il représente la première cause de décès par cancer chez la femme.

➡️Détecté tôt, le cancer du sein est guéri dans 90% des cas.… https://twitter.com/NemesisNemesi75/status/1710259020940849228/photo/1",36,118,2,156
433,1710239341803356634,2023-10-06 10:23:28,NemesisNemesi75,Visiblement chez #LFI on ne se contente pas d’applaudir à l’Assemblée Nationale des hommes condamnés pour violences conjugales : on empêche aussi que des propositions de lois soient votées alors qu’elles amélioreraient la vie de millions de femmes. Le motif ? Elles sont proposées…,141,438,5,584
434,1710234464322818085,2023-10-06 10:04:05,NemesisNemesi75,"Encore une fois, la gauche et la majorité est plus préoccupée par le fait de se distinguer du @RNational_off plutôt que du bien être des femmes. Une attitude LAMENTABLE: 

La proposition de loi du Rassemblement national visant à mieux accompagner les femmes atteintes…",340,970,19,1329
435,1710232489522757855,2023-10-06 09:56:14,NemesisNemesi75,"Une mère de famille a été tuée d'une quinzaine de coups de couteau la nuit dernière, sous les yeux de ses 4 enfants, à Pierre-Bénite, dans la métropole de Lyon. 

Son compagnon âgé de 56 ans a été interpellé et placé en garde à vue.

https://actu17.fr/faits-divers/pierre-benite-une-femme-poignardee-a-mort-devant-ses-enfants-le-compagnon-interpelle.html",148,224,2,374
436,1710202543370846590,2023-10-06 07:57:15,NemesisNemesi75,"Un homme « totalement centré sur lui-même » avec « des constantes qui sont incontournables : ne pas travailler d’une part, et d’autre part assouvir ses passions, à savoir les Legos® et le sexe » affirme Mme l’avocat général à propos d’Evariste Galvez, un père de famille.

Le père…",21,64,0,85
437,1710198892220842361,2023-10-06 07:42:44,NemesisNemesi75,"Alexandre, 27 ans, a été reconnu coupable de viol commis sous la menace d’une arme les 10 et 11 juin 2016 à Breuillet. Il écope de 10 ans de prison.

La victime avait été séquestrée et violée à Breuillet, les 10 et 11 juin 2016.

Selon la victime, le 10 août au soir, l’accusé a…",318,775,31,1124
438,1709836684924166251,2023-10-05 07:43:27,NemesisNemesi75,"Taha Zraibia condamné à 25 ans de réclusion criminelle assortie d'une peine de sûreté des 2/3.

Cet homme de 36 ans était jugé pour avoir tué Johanna Dias, fin 2018, à Pannes, d'une cinquantaine de coups de couteau.

Il avait déjà été condamné pour violences conjugales.…",246,489,17,752
439,1709827702927097894,2023-10-05 07:07:46,NemesisNemesi75,"Un éleveur de bovins installé au May-sur-Èvre, a été condamné lundi 2 octobre à trois ans de prison, dont une année ferme. Il a été reconnu coupable de multiples infractions, dont des agressions sexuelles sur les jeunes femmes qu’il recevait dans son exploitation.…",33,129,3,165
440,1709674963085496605,2023-10-04 21:00:50,NemesisNemesi75,"Un appel lancé par la gendarmerie du Var (@Gendarmerie_083): scolarisée au collège Paul Cézanne à Brignoles, Théa Ternier, âgée de 15 ans a disparu depuis ce mardi.

Si vous avez des informations permettant d'aider les enquêteurs, contacter le 04.94.69.03.90 ou le 17  24h/24h et… https://twitter.com/NemesisNemesi75/status/1709674963085496605/photo/1",352,300,5,657
441,1709553987026915789,2023-10-04 13:00:07,NemesisNemesi75,"@nostalgia_d En effet, ça ressemble à un post pour vaincre les punaises de lit. Mais nous sommes bien plus coriaces qu’elles malheureusement.",0,47,1,48
442,1709550991740195129,2023-10-04 12:48:13,NemesisNemesi75,"« Evitez la confrontation directe » 😭
En effet, vous risqueriez de tomber sous le charme de nos militantes 😎. 

➡️Sur leur instagram, les jeunes socialistes du Doubs ont peur de nous :( https://twitter.com/NemesisNemesi75/status/1709550991740195129/photo/1",171,712,41,924
443,1709476479602770349,2023-10-04 07:52:07,NemesisNemesi75,"Si vous voulez nous faire de la pub @libe , faites-le correctement: vous avez oublié de dire que nous étions aussi présentes à Strasbourg, Lille, Lyon, Nantes, Chambéry, en Suisse… 

➡️et pour nous rejoindre c’est par ici:

https://www.collectif-nemesis.com « libe: Carte interactive des groupuscules d’extrême droite : ils sont (vraiment) partout

Qui sont-ils ? Où agissent-ils ? Au nom de quelle idéologie ? Libé vous répond grâce à une carte exclusive ➡️ https://bit.ly/3rqYhe4 https://twitter.com/libe/status/1709151742892327209/photo/1 — https://twitter.com/libe/status/1709151742892327209 »",213,740,10,963
444,1709471372718592505,2023-10-04 07:31:50,NemesisNemesi75,"Paris : Une jeune femme affirme avoir été violée dans la rue Oberkampf dans le XIeme arrondissement. Un homme à vélo se serait jeté sur elle avant de la plaquer brutalement contre un mur et d'abuser d'elle sexuellement.

La victime a pris la fuite et a regagné son domicile. C'est…",527,1142,55,1724
445,1709141850248900969,2023-10-03 09:42:26,NemesisNemesi75,"Un migrant Albanais écroué pour avoir violemment agressé 4 femmes âgées en l’espace de quelques jours seulement. Il arrachait leurs colliers.

https://actu17.fr/faits-divers/nice-il-agressait-les-femmes-agees-pour-leur-arracher-leur-collier-un-homme-ecroue.html",375,582,17,974
446,1708858472878535144,2023-10-02 14:56:23,NemesisNemesi75,"Le 1 octobre 2017, Mauranne et Laura, deux cousines de 20 ans, étaient égorgées par Ahmed Hanachi, un migrant tunisien. 

Nous ne les oublions pas. Nous n’oublions pas non plus que ce sont des victimes qui auraient pu être épargnées si nos frontières étaient gardées.

(photo de… https://twitter.com/NemesisNemesi75/status/1708858472878535144/photo/1",645,1325,24,1994
447,1708802447303422158,2023-10-02 11:13:46,NemesisNemesi75,"Paris : deux hommes interpellés à Barbès pour viol et séquestration d’une jeune fille mineure. La victime a été violée sous l’effet de protoxyde d’azote. 

Les deux hommes devaient ramener la jeune fille à son domicile mais ils l’ont emmenée dans un hôtel en Seine-Saint-Denis…",701,1304,65,2070
448,1708754759161614529,2023-10-02 08:04:16,NemesisNemesi75,"Toulouse : Une femme dans le coma après avoir été traînée sur une vingtaine de mètres par un chauffeur VTC.

Selon la version du chauffeur, sa cliente se trouvait dans l’incapacité de payer la course. Il aurait alors pris la décision de lui confisquer son téléphone en guise de…",743,1440,110,2293
449,1707745704678920553,2023-09-29 13:14:39,NemesisNemesi75,"@Ereminette D’ailleurs à ce sujet : les statistiques de l’INSEE en 2015 à ce sujet montrent qu’il y a autant d’hommes que des femmes de nationalité étrangère dans les mariages mixtes.

Et encore une fois il n’est que question de nationalité. Cela ne nous dit rien de l’ethnie de ces hommes et…",5,39,1,45
450,1707740618091348359,2023-09-29 12:54:26,NemesisNemesi75,"À Le Perreux-sur-Marne, une femme de 87 ans victime d'une tentative de viol à son domicile par un plombier. Celui-ci a pris la fuite.

La victime s'est mise à hurler et s'est débattue. L'agresseur a finalement quitté les lieux. L'octogénaire s'est réfugiée chez une voisine, qui a…",542,1031,94,1667
451,1707661816245944580,2023-09-29 07:41:18,NemesisNemesi75,"Georges Marquez, 64 ans, a été condamné à quatre ans de prison pour agressions sexuelles commises sur sa belle-fille et sa petite belle-fille. Il est parti directement en détention ce jeudi 28 septembre.

https://www.sudouest.fr/pyrenees-atlantiques/pau/bearn-une-mere-et-sa-fille-agressees-sexuellement-a-quinze-ans-d-ecart-l-auteur-condamne-16845189.php",55,126,8,189
452,1707661291974795700,2023-09-29 07:39:13,NemesisNemesi75,"Disparition inquiétante : Asya Goktas, une jeune fille de 12 ans ne donne plus de signes de vie depuis 3 jours.

Elle a été vue pour la dernière fois dans les Yvelines.

L’avis de recherche précise que si vous avez des informations, vous pouvez contacter le commissariat de… https://twitter.com/NemesisNemesi75/status/1707661291974795700/photo/1",357,348,13,718
453,1707655178030084453,2023-09-29 07:14:55,NemesisNemesi75,"Tours: Hermann Z. est accusé d’avoir drogué plusieurs femmes à leur insu, qui ont dénoncé des agressions sexuelles et des viols. Jugé depuis mercredi 27 septembre 2023 devant la cour criminelle départementale, le trentenaire nie les faits.

https://www.lanouvellerepublique.fr/tours/accusations-de-viols-a-tours-les-trips-nocturnes-d-hermann https://twitter.com/NemesisNemesi75/status/1707655178030084453/photo/1",94,136,4,234
454,1707653531749040244,2023-09-29 07:08:23,NemesisNemesi75,"« Je n’ai pas réalisé leur avoir fait du mal. J’aurais dû respecter leur volonté », a confié un père de famille jugé à Carcassonne pour plus d’une cinquantaine de viols conjugaux. 

Un homme résidant à Narbonne a été condamné à huit ans de prison mercredi par la cour d’assises de…",84,256,13,353
455,1707382878810656976,2023-09-28 13:12:54,NemesisNemesi75,"Ramon Lopez Rodriguez, un Équatorien de 46 ans ouvrier agricole sera jugé à partir d’aujourd’hui jusqu’à demain pour le viol d’une mère de famille.

Les faits se sont produits en septembre 2020. La mère de famille travaillait avec lui sur une exploitation agricole à Sabres.…",114,230,2,346
456,1707375931638030677,2023-09-28 12:45:18,NemesisNemesi75,"Mardi 26 septembre 2023, une adolescente de 14 ans a été découverte séquestrée depuis six jours par sa famille à Drancy en Seine-Saint-Denis. La victime devait dormir à même le sol et faire ses besoins dans un seau. 

Les parents et le frère de l’adolescence auraient enfermé la…",126,287,11,424
457,1707315544821555409,2023-09-28 08:45:20,NemesisNemesi75,"«Aucune personne entrant au Royaume-Uni par bateau depuis la France ne fuit un péril imminent»

«La Convention de Genève confère à au moins 780 millions de personnes le droit théorique de s’installer dans un autre pays»

«Nous ne pourrons pas maintenir un système d’asile si le… https://twitter.com/NemesisNemesi75/status/1707315544821555409/photo/1",497,1176,28,1701
458,1707307494773608946,2023-09-28 08:13:21,NemesisNemesi75,"Mardi 19 septembre à La Rochelle Caroline Coulon (42 ans) a été abattue, avec une arme à feu, par son ex-mari, Romain Marty. L'homme s'est ensuite suicidé en retournant l'arme contre lui. 

C’est le nouveau compagnon de la victime qui a découvert les corps. La victime était… https://twitter.com/NemesisNemesi75/status/1707307494773608946/photo/1",56,188,9,253
459,1707305945083044324,2023-09-28 08:07:12,NemesisNemesi75,"SCANDALEUX : à Nancy, un meurtrier condamné à 20 ans de prison pour le meurtre de sa compagne en 2004 est déjà dehors en 2019. 

Sans surprise, il récidive et commet des violences sur sa nouvelle campagne à laquelle il avait caché son passé.

#justicelaxiste #justicecomplice…",479,738,18,1235
460,1707303440810987524,2023-09-28 07:57:15,NemesisNemesi75,"Patrick Tissier, condamné à 30 ans de prison incompressible en 1998 pour le viol et le meurtre de la petite Karine (8 ans) en septembre 1993,  va pouvoir déposer une demande de remise en liberté. 

Il avait aussi été condamné pour le viol et le meurtre de Concetta Lemma, ainsi… https://twitter.com/NemesisNemesi75/status/1707303440810987524/photo/1",298,633,46,977
461,1707300983456297152,2023-09-28 07:47:29,NemesisNemesi75,"Morad Aggoun, un élu PS et adjoint à la maire de Vaulx-en-Velin comparait jusqu'à vendredi devant la cour d'assises du Rhône pour viol, agressions sexuelles et harcèlement sexuel sur trois ex-salariés de la mairie en 2016.

https://www.lefigaro.fr/lyon/a-lyon-un-ancien-elu-juge-a-huis-clos-pour-viol-et-agressions-sexuelles-sur-trois-secretaires-de-mairie-20230925 https://twitter.com/NemesisNemesi75/status/1707300983456297152/photo/1",315,369,20,704
462,1707299845503926738,2023-09-28 07:42:57,NemesisNemesi75,"Un homme de 46 ans, originaire du nord Franche-Comté est jugé à partir de ce mercredi par la cour criminelle départementale du Territoire de Belfort à Vesoul, pour viol et agression sexuelle envers 4 jeunes mineures. Sa fille et ses deux nièces font partie des victimes.…",93,258,6,357
463,1707297686502650316,2023-09-28 07:34:23,NemesisNemesi75,"Le procès d’Abdelhakim Haddouche se tiendra ce jeudi jusqu’à demain à Perigueux en Dordogne. Il sera jugé pour le viol d’une jeune mère de famille le 20 janvier 2022.

Originaire d’Algérie, le trentenaire était arrivé en France peu avant les faits pour y chercher du travail. À…",340,616,26,982
464,1707046528680911031,2023-09-27 14:56:22,NemesisNemesi75,"Il y a 3 ans, Victorine Dartois croisait la route de Ludovic Bertin. Deux jours plus tard, elle sera retrouvée morte dans un ruisseau. Ludovic Bertin admettra l’avoir étranglée.

Nous ne l’oublions pas.

Nous n’oublions pas non plus que ce drame aurait pu être évité : 

Ludovic… https://twitter.com/NemesisNemesi75/status/1707046528680911031/photo/1",779,1727,41,2547
465,1707025349135970774,2023-09-27 13:32:12,NemesisNemesi75,"Marseille : une femme de 54 ans poignardée à plusieurs reprises à la sortie du tribunal judiciaire de Marseille mardi matin.

Son mari, avec qui elle est en instance de divorce, est le principal suspect et a pris la fuite. 

https://actu17.fr/faits-divers/marseille-une-femme-poignardee-a-plusieurs-reprises-a-la-sortie-du-tribunal-son-mari-en-fuite.html",145,232,12,389
466,1707024381598175319,2023-09-27 13:28:22,NemesisNemesi75,"Avignon: Farid, un homme de 25 ans en situation irrégulière agresse violemment deux femmes âgées de 81 et 94 ans pour les dépouiller.

➡️Jugé vendredi dernier au tribunal correctionnel, cet homme en situation irrégulière en France a écopé d'une peine de quatre ans de prison ferme…",365,860,42,1267
467,1706925011175391675,2023-09-27 06:53:30,NemesisNemesi75,"La direction territoriale de la @CroixRouge Réunion est actuellement en proie à de graves dysfonctionnements notamment au centre d'hébergement des demandeurs d'asile (où certaines structures sont mixtes).

Une demandeuse d'asile tamoule aurait été agressée sexuellement par l’un…",420,796,25,1241
468,1706918444971524525,2023-09-27 06:27:24,NemesisNemesi75,"Joël Merland, 77 ans, comparaît en appel aux assises de Bordeaux jusqu’à vendredi.

Il est accusé de viols, d’une tentative de viol et d’agressions sexuelles réalisés durant des séances de magnétisme sur 16 femmes, âgées de 16 à 75 ans. Il a été condamné en première instance à 15…",53,158,5,216
469,1706699243166056864,2023-09-26 15:56:23,NemesisNemesi75,"Un homme de 54 ans a contacté le commissariat de Toulouse ce mardi matin pour signaler qu'il avait tué son épouse de 51 ans, et qu'il souhaitait se rendre. 

Selon les premières constatations, ""l'arme ayant servi à l'agression pourrait être une massette avec laquelle plusieurs…",98,309,14,421
470,1706608503652020674,2023-09-26 09:55:49,NemesisNemesi75,"Notre porte parole @mathildaNemesis a été invitée dans l’émission « Le Dernier Verre » avec @andrebercoff 

➡️Une vidéo à voir en entier sur la chaîne YouTube d’ @Omerta_officiel

https://youtu.be/D6FUhfMkhsU?si=7_v6KF7qfoQ4WjSL https://twitter.com/NemesisNemesi75/status/1706608503652020674/video/1",114,262,2,378
471,1706584959798939805,2023-09-26 08:22:15,NemesisNemesi75,"Le procès de Dylan Aubel, un Martiniquais de 25 ans, s’est ouvert le lundi 25 septembre. Il est jugé pour le viol d’une veuve de 88 ans en Dordogne en 2021. 

Les experts psychiatres expliquent que l’accusé coche toutes les cases de la personnalité du psychopathe et indiquent…",289,617,23,929
472,1706581735310250093,2023-09-26 08:09:27,NemesisNemesi75,"Plus de 20 ans après les faits, Raymond Touillet est jugé pour le meurtre et le viol de  Chantal de Chillou de Saint-Albert (55 ans) en 2001. Le procès débute ce lundi à Valence.

Raymond Touiller était déjà ""depuis 2008 enregistré dans le Fnaeg"" après une condamnation pour…",53,129,1,183
473,1706580085099135009,2023-09-26 08:02:53,NemesisNemesi75,"« C’est une torture » explique Fanny, la mère de #Lina. Sa fille de 15 ans a disparu depuis samedi matin à Schirmeck. Une première journée de battue a été organisée ce lundi.

https://www.bfmtv.com/alsace/c-est-une-torture-la-mere-de-lina-s-exprime-apres-la-premiere-journee-de-battue-pour-retrouver-la-jeune-fille_AP-202309250825.html",185,466,21,672
474,1706556658816524773,2023-09-26 06:29:48,NemesisNemesi75,"Tours : Ala A. H.,un réfugié soudanais, a été interpellé pour tentative de viol sur une femme de 67 ans dimanche 24 septembre .

https://www.valeursactuelles.com/faits-divers/info-va-tours-un-refugie-soudanais-interpelle-pour-tentative-de-viol-sur-une-femme-de-67-ans",256,344,20,620
475,1706555180257350102,2023-09-26 06:23:55,NemesisNemesi75,"À Saint-Étienne-du-Rouvray, une adolescente de 14 ans rouée de coups par 5 jeunes. Une agression filmée et publiée sur les réseaux sociaux. Cinq mineurs entre 13 et 14 ans ont été interpellés. Trois seront jugés en décembre prochain au tribunal pour enfants.…",575,1121,61,1757
476,1706348544242643313,2023-09-25 16:42:50,NemesisNemesi75,"Nice : dans la nuit de Samedi à Dimanche, une femme a été agressée dans la rue par un homme de nationalité algérienne. Les enquêteurs ont découvert qu’il était  entré illégalement sur le territoire. 

https://www.lefigaro.fr/nice/nice-un-policier-en-civil-vient-en-aide-a-une-femme-frappee-en-pleine-rue-par-un-sans-papiers-20230925",468,640,40,1148
477,1706338116888379723,2023-09-25 16:01:23,NemesisNemesi75,"« Pensez-vous qu’il soit possible de bloquer les migrants mais que l’UE ne veuille pas le faire ? » demande une militante. «Je ne sais pas mais il y a quelque chose de gros derrière » répond Attilio Lucia, maire adjoint de #Lampedusa.

➡️L’interview est à visionner en intégralité… https://twitter.com/NemesisNemesi75/status/1706338116888379723/video/1",518,744,19,1281
478,1706336288062742689,2023-09-25 15:54:07,NemesisNemesi75,"Grenoble : un homme de 36 ans en situation irrégulière sur le territoire français mis en examen pour le viol d’une étudiante dans un hall d’immeuble. 

Il faisait déjà l’objet d’un mandat d’arrêt pour « violences conjugales » et « viol conjugal ».

https://www.20minutes.fr/faits_divers/4054682-20230925-grenoble-suspect-mis-examen-viol-etudiante-hall-immeuble",714,883,25,1622
479,1706322686891180443,2023-09-25 15:00:05,NemesisNemesi75,"Pour la deuxième fois en quinze jours, le Conseil d'État était appelé à se prononcer sur l'interdiction de l'abaya dans les établissements scolaires. 

➡️Pour la seconde fois, il estime ""qu’il n’existe pas de doute sérieux sur la légalité de l’interdiction"" par les établissements…",118,370,11,499
480,1706270727794544860,2023-09-25 11:33:37,NemesisNemesi75,"Nous ne sommes que lundi est déjà 2 viols auraient pu être évités à des femmes françaises si les OQTF avaient été appliquées…

Combien de femmes  doivent-elles être sacrifiées pour que ça change ?",1242,2804,68,4114
481,1706267525338550616,2023-09-25 11:20:53,NemesisNemesi75,"EDIT : Un Algérien sous OQTF depuis février 2022 interpellé pour le viol d’une femme de 68 ans à Versailles le 19 septembre dernier.

https://www.lejdd.fr/societe/versailles-une-femme-de-67-ans-violee-son-domicile-138496 « NemesisNemesi75: Une femme de 67 ans séquestrée, frappée et violée durant toute une nuit à Versailles. 

Ce n’est qu’au petit matin que la victime a réussi à se défaire de son bourreau, se réfugiant chez une voisine. 

L’agresseur, que la victime ne connaissait pas, est toujours en fuite.… — https://twitter.com/nemesisnemesi75/status/1705201102017171817 »",199,249,9,457
482,1706190811283534086,2023-09-25 06:16:03,NemesisNemesi75,"Nous apprenons que le Malien de 31 ans en situation irrégulière qui a été écroué après le viol d’une étudiante près des Champs-Élysées le 19 septembre était DÉJÀ connu des services de police pour un précédent viol présumé. Un viol commis au sein de cette même boîte de nuit, en…",1873,4045,169,6087
483,1706188803130511685,2023-09-25 06:08:04,NemesisNemesi75,"🛑AVIS DE RECHERCHE🛑 

La gendarmerie de Schirmeck lance un avis de recherche pour retrouver Lina, 15 ans.

L'adolescente, 1,60 m et cheveux mi-longs blonds, n’a plus donné signe de vie depuis samedi 23 septembre à 11 h 15. Habillée d’une robe grise et d’une doudoune blanche,…",421,461,8,890
484,1706187184934437092,2023-09-25 06:01:38,NemesisNemesi75,"Dylan Audel, 25 ans, sera jugé du lundi 25 au mercredi 27 septembre devant la cour d’assises de la Dordogne, pour le viol d’une dame âgée de 89 ans, le 21 juillet 2021 à Thiviers.

https://www.sudouest.fr/justice/viol-d-une-octogenaire-chez-elle-un-homme-de-25-ans-juge-en-dordogne-16682716.php",66,95,2,163
485,1705901632813244731,2023-09-24 11:06:58,NemesisNemesi75,"À Avignon, une femme de 51 ans est agressée par un migrant de 21  en situation irrégulière alors qu’elle rentrait chez elle.

L'homme a été REMIS EN LIBERTÉ. Il est convoqué devant la justice en avril prochain. 

https://actu17.fr/faits-divers/avignon-une-femme-de-51-ans-agressee-sexuellement-en-rentrant-chez-elle-un-suspect-de-21-ans-interpelle.html",683,952,81,1716
486,1705264707215516036,2023-09-22 16:56:03,NemesisNemesi75,"🎥[TEMOIGNAGE] 🎥Lors de notre venue à Lampedusa, nous avons eu la chance de rencontrer Attilio Lucia, maire adjoint de la commune de #Lampedusa. 

Dans cette interview, il nous explique comment, complètement excédé par la situation migratoire sur son île, la mairie et les… https://twitter.com/NemesisNemesi75/status/1705264707215516036/video/1",531,862,17,1410
487,1705260217192063070,2023-09-22 16:38:12,NemesisNemesi75,"Nice : Adel A. et Mohamed E. violent, torturent et dépouillent une femme de 30 ans dans un parking souterrain dans 
la nuit du 12 au 13 août dernier.

https://actu17.fr/faits-divers/nice-une-femme-violee-torturee-et-depouillee-dans-un-parking-deux-suspects-ecroues.html",1118,1327,120,2565
488,1705201102017171817,2023-09-22 12:43:18,NemesisNemesi75,"Une femme de 67 ans séquestrée, frappée et violée durant toute une nuit à Versailles. 

Ce n’est qu’au petit matin que la victime a réussi à se défaire de son bourreau, se réfugiant chez une voisine. 

L’agresseur, que la victime ne connaissait pas, est toujours en fuite.…",881,1603,86,2570
489,1705137300114391404,2023-09-22 08:29:46,NemesisNemesi75,"Le père de Mégane, la victime de d’Oumar Ndiaye à Cherbourg , dénonce le manque de soutien du gouvernement. 

Il reproche notamment au gouvernement un manque d'accompagnement ""dans les démarches auxquelles sa famille a dû faire face dans de telles circonstances"". 

L’état de…",949,2240,80,3269
490,1704907256637063483,2023-09-21 17:15:40,NemesisNemesi75,"Gianlucas est commerçant sur l’île de #Lampedusa. 

Il nous explique les difficultés que connaissent les commerçants à cause de l’arrivée massive de migrants sur cette île magnifique. 

➡️L’Europe doit agir pour aider les Italiens. Elle doit agir pour empêcher l’arrivée des… https://twitter.com/NemesisNemesi75/status/1704907256637063483/video/1",354,695,17,1066
491,1704877341044830523,2023-09-21 15:16:47,NemesisNemesi75,Le passage de notre présidente @CordierAlice2 sur CNEWS à #Lampedusa https://twitter.com/NemesisNemesi75/status/1704877341044830523/video/1,114,281,5,400
492,1704769163904884999,2023-09-21 08:06:56,NemesisNemesi75,"""C’est comme un meurtre de l'intérieur"" décrit Cybille, 25 ans,une victime de viols incestueux. 

Son beau-père a été condamné à 12 ans de prison ferme avec mandat de dépôt.

Son beau-père l’a violée à de nombreuses reprises entre ses 10 et ses 14 ans.  Son calvaire a commencé en… https://twitter.com/NemesisNemesi75/status/1704769163904884999/photo/1",146,470,14,630
493,1704767673769275805,2023-09-21 08:01:01,NemesisNemesi75,"Rais Saintini, 36 ans, jugé au tribunal de Chartres pour de graves violences et viol sur sa compagne.

Les actes qui sont reprochés à l’accusé, se seraient déroulés dans un contexte de rupture voulu par sa compagne, et d’alcoolisation et de consommation de stupéfiants.

Le…",41,134,0,175
494,1704767028106567850,2023-09-21 07:58:27,NemesisNemesi75,"Seine-et-Marne : deux hommes de 18 et 49 ans en garde à vue pour le viol en réunion et la séquestration d’une ado de 15 ans.

La victime de 15 ans, originaire du nord de la France, avait récemment fugué du domicile familial et aurait rejoint les deux suspects en Ile-de-France.…",392,742,39,1173
495,1704765233829445680,2023-09-21 07:51:19,NemesisNemesi75,"Viols, séquestration, tortures: 

Samedi à #Nantes dans le quartier Malakoff, deux hommes ont été interpellés. Ils sont suspectés de torture et d'actes de barbarie sur quatre personnes (dont deux femmes). L’une des deux femmes a mentionné avoir été «violée sous la menace d’une…",500,939,40,1479
496,1704755423457267995,2023-09-21 07:12:20,NemesisNemesi75,"Quelle arnaque vu que l’étude en question ne prend en compte que la nationalité et non pas l’ethnicité des délinquants et criminels. Une arnaque qui ne marche plus d’ailleurs sur la plupart des gens. « captaineco_fr: Les lecteurs, désormais mieux informés de la part des natifs dans la délinquance, ont réalisé que la majorité des crimes et délits étaient en réalité le fait d’individus nés dans leur pays. En revanche, l’inquiétude envers la délinquance en général a augmenté. — https://twitter.com/captaineco_fr/status/1704417286931509288 »",173,644,19,836
497,1704741754212077651,2023-09-21 06:18:01,NemesisNemesi75,"L'auteur présumé d'un viol filmé et affiché sur les réseaux sociaux : une enquête ouverte à Tourcoing après la diffusion d'une vidéo où un jeune-homme est passé à tabac. Plusieurs internautes affirment qu'il s'agit de l'auteur présumé de l'agression d'une jeune-fille, dont la…",363,782,46,1191
498,1704481413557317822,2023-09-20 13:03:31,NemesisNemesi75,"Les femmes françaises légèrement plus favorables à l’instauration d’un blocus naval afin d’empêcher l’afflux de migrants en Méditerranée : 70% des femmes contre 69% des hommes.

➡️Contrairement aux images diffusées ces derniers jours à #Lampedusa, les femmes militantes… https://twitter.com/NemesisNemesi75/status/1704481413557317822/photo/1",528,1386,43,1957
499,1704434982922473702,2023-09-20 09:59:01,NemesisNemesi75,"🛑Dans cette seconde partie de notre échange avec une migrante économique camerounaise rencontrée à Lampedusa, elle nous confirme ce que nous savions déjà : l’immigration africaine en Europe est purement économique. 🛑

avec @CordierAlice2 

#Lampedusa #Migrant https://twitter.com/NemesisNemesi75/status/1704434982922473702/video/1",1049,1920,184,3153
500,1704406039855092016,2023-09-20 08:04:00,NemesisNemesi75,"Strasbourg : une jeune femme de 22 ans entre la vie et la mort après avoir été torturée et violée par un homme de 58 ans. La victime est hospitalisée avec un pronostic vital engagé.

L’homme a été placé en garde à vue et, encore une fois, il est déjà connu des services de police,…",1110,2036,94,3240
501,1704181684172734524,2023-09-19 17:12:30,NemesisNemesi75,"🛑« C’est plus cher de prendre l’avion qu’un passeur » nous explique l’une des rares femmes arrivées à Lampedusa, migrante économique camerounaise.🛑

➡️Découvrez dans cette vidéo le prix dérisoire d’une traversée Tunisie/Europe. 😳😳😳

D’autres extraits de notre échange avec… https://twitter.com/NemesisNemesi75/status/1704181684172734524/video/1",983,1474,93,2550
502,1704152980415488484,2023-09-19 15:18:26,NemesisNemesi75,"« Les demandeuses d'asile subissent souvent des violences sexuelles une fois arrivées en France, selon une enquête ».  

FranceTvinfo sous entend dans son titre que ces femmes sont violées par des français à leur arrivée.
⬇️

https://www.francetvinfo.fr/monde/europe/migrants/les-demandeuses-d-asile-subissent-souvent-des-violences-sexuelles-une-fois-arrivees-en-france-selon-une-enquete_6069336.html",363,933,181,1477
503,1703862412154155330,2023-09-18 20:03:49,NemesisNemesi75,"Notre présidente @CordierAlice2 et quelques militantes sont actuellement à #Lampedusa « CordierAlice2: Il paraît que je parle des migrants sans les connaître ? C’est ce qu’on va voir. 

Première soirée à #Lampedusa.

Nous sommes allées repérer le hotspot mais impossible d’y entrer à moins d’être bénévoles.

Derrière moi vous voyez le lieu où débarquent les migrants et où ils sont… https://twitter.com/CordierAlice2/status/1703846013033689214/video/1 — https://twitter.com/cordieralice2/status/1703846013033689214 »",106,387,15,508
504,1703822071694848375,2023-09-18 17:23:32,NemesisNemesi75,"«La France ne s'apprête pas à accueillir une partie des migrants» assurait Gérald Darmanin ce matin. 

Quelques heures plus tard, on apprend que la ville de Menton s’apprête à accueillir 200 personnes PAR JOUR. 

Évidemment Yves Juhel, le maire LR de Menton nous explique qu'il…",636,1967,74,2677
505,1703785273442566399,2023-09-18 14:57:18,NemesisNemesi75,"Selon les données croisées de 2021 de l’INSEE et du SSMSI, le taux de mis en cause pour des violences sexuelles des personnes de nationalité française est de 0,070% tandis que celui des personnes étrangères en provenance d’Afrique est de 0,21 %. Un taux donc 3 fois supérieur.… https://twitter.com/NemesisNemesi75/status/1703785273442566399/photo/1",609,1053,47,1709
506,1703686044296634731,2023-09-18 08:23:00,NemesisNemesi75,"Seulement 3 ans de prison pour  Chrislain.P qui, le 11 septembre dernier à la Réunion, a tabassé sa compagne handicapée et tenté de lui crever les yeux. Il a aussi tenté d’attaquer son voisin au couteau pour être intervenu. Cette tentative de meurtre a été correctionnalisée.…",247,557,7,811
507,1703657837493190986,2023-09-18 06:30:55,NemesisNemesi75,"Une illustration parfaite du fonctionnement LUNAIRE de notre justice: un homme déjà condamné à la « perpétuité » va sûrement être condamné à la «perpétuité » une seconde fois 🤡

Douze ans après avoir tué Laëtitia Perrais près de Pornic (Loire-Atlantique), Tony Meilhon a été… https://twitter.com/NemesisNemesi75/status/1703657837493190986/photo/1",623,1637,164,2424
508,1703653644057424075,2023-09-18 06:14:15,NemesisNemesi75,"3 hommes accusés de viol seront jugés par la cour criminel du Calvados du lundi 18 au vendredi 22 septembre 2023 :

-Un agriculteur de la région de Vire, âgé de 43 ans, sera jugé pour le viol, en décembre 2019, de son ancienne compagne de 36 ans.

-Un homme de 58 ans, employé…",82,243,4,329
509,1703651106897695054,2023-09-18 06:04:10,NemesisNemesi75,"En Vendée, un médecin est mis en examen pour des soupçons de viol sur une patiente « fragile ». L'homme était déjà sous le coup d'un sursis probatoire en raison d'une récente condamnation pour des faits de violences conjugales. 

https://m.20minutes.fr/amp/a/4053409",49,108,2,159
510,1703351125636743481,2023-09-17 10:12:09,NemesisNemesi75,"Tu es de Lille ou aux alentours ? Tu veux militer avec nous ? 

➡️Contacte-nous à cette adresse :nemesislille59000@gmail.com https://twitter.com/NemesisNemesi75/status/1703351125636743481/photo/1",265,754,16,1035
511,1702687908262469653,2023-09-15 14:16:46,NemesisNemesi75,"François Gemenne qualifie @MarionMarechal de « pin-up » en direct à propos de sa venue à #Lampedusa.

On aimerait voir les néo-feministes si promptes à dénoncer toutes les attaques sexistes à le faire AUSSI quand c’est une femme de droite comme @MarionMarechal qui en est victime.… https://twitter.com/NemesisNemesi75/status/1702687908262469653/photo/1",869,2336,82,3287
512,1702677904520323402,2023-09-15 13:37:01,NemesisNemesi75,À #Lampedusa : Plus de 10 000 personnes en provenance d'Afrique y ont débarqué depuis lundi. https://twitter.com/NemesisNemesi75/status/1702677904520323402/photo/1,873,2125,46,3044
513,1702638465161072788,2023-09-15 11:00:18,NemesisNemesi75,"@matthlevesque1 Pouvons-nous avoir une source de votre affirmation disant sue «60% des femmes entre 18 et 34 ans votent NUPES » svp ?

Parce que, selon les données disponibles de l’IFOP pour la présidentielle 2022:

Jean-Luc Mélenchon a obtenu 3 points de plus de la part des électeurs masculins…",6,31,1,38
514,1702611676405641688,2023-09-15 09:13:51,NemesisNemesi75,"Citez-nous un seul pays qui a vu la condition des femmes s’améliorer en même temps qu’il a vu l’essor de l’islam (et donc du voile) s’étendre ? 

Aucun pays musulman dans la liste du classement mondial sur l’égalité des sexes 2022 : Afghanistan🇦🇫 , Pakistan 🇵🇰 , Iran 🇮🇷, Algérie… https://twitter.com/NemesisNemesi75/status/1702611676405641688/photo/1",695,1696,57,2448
515,1702593588708712522,2023-09-15 08:01:58,NemesisNemesi75,"Muhamad Usman, un Pakistanais, a violé Marie-Christine le 9 avril 2021. 

Il est condamné à 10 ans de réclusion. Aucune interdiction du territoire n’a été prononcée.

https://www.bienpublic.com/faits-divers-justice/2023/09/14/muhamad-usman-condamne-a-dix-ans-de-reclusion-criminelle-pour-viol",458,642,33,1133
516,1702521788129792283,2023-09-15 03:16:40,NemesisNemesi75,@FireFla56682991 @canamagoo @RevPermanente Encore raté: on a posté sur les victimes Alexia Daval et son assassin Jonathan Daval et sur Justine Vayrac et son assassin Lucas (pour rappel on parle des violences faites aux femmes hein) https://twitter.com/NemesisNemesi75/status/1702521788129792283/photo/1,3,3,0,6
517,1702368603079672108,2023-09-14 17:07:58,NemesisNemesi75,"Pour ceux qui n’auraient pas la référence :
lundi 11 septembre, l’entreprise Sephora qui appartient au groupe LVMH dirigé par Bernard Arnault, a diffusé sur ses réseaux un clip tourné avec des membres de l'équipe de football des Hijabeuses. 

#BoycottSephora #BoycottLVMH https://twitter.com/NemesisNemesi75/status/1702368603079672108/photo/1",672,1146,49,1867
518,1702347317427183894,2023-09-14 15:43:23,NemesisNemesi75,"Un Érythréen a violé une femme dimanche à Dijon. Un Congolais a frappé et brûlé une femme avec un fer à repasser mardi en Essonne. Un Guinéen a violé une ado à Gare du Nord mercredi. Un Angolais a sauté à pieds joints sur la tête d’une femme à Nice lundi…

Mais allons-y,… https://twitter.com/NemesisNemesi75/status/1702347317427183894/photo/1",8219,12198,890,21307
519,1702333725407858976,2023-09-14 14:49:22,NemesisNemesi75,"La petite île de Lampedusa en Italie connaît actuellement l’une de ses plus massives arrivées de migrants avec 6000 migrants arrivés en 24h.

Les autorités de l’île ont décrété l’état d’urgence mercredi soir.

Nos pensées vont aux habitants de Lampedusa qui n’ont rien demandé et… https://twitter.com/NemesisNemesi75/status/1702333725407858976/photo/1",532,1697,101,2330
520,1702282712789193127,2023-09-14 11:26:40,NemesisNemesi75,"Une jeune femme violée en pleine rue à Dijon par un homme d'origine érythréenne dimanche 3 septembre dans la soirée.

Les faits se sont produits vers 23 heures à hauteur du boulevard de l'Ouest, situé entre le lac Kir et la gare. La jeune femme marchait le long de l'artère…",691,1341,59,2091
521,1702264599997739086,2023-09-14 10:14:41,NemesisNemesi75,"Un extrait de l’intervention de notre présidente @CordierAlice2 qui a été invitée sur @CNEWS hier pour parler de l’insécurité et des violences que vivent les femmes dans les transports. Les arguments avancés par Alice ne vont pas plaire au chroniqueur Karim Zeribi…

➡️Son… https://twitter.com/NemesisNemesi75/status/1702264599997739086/video/1",918,1977,112,3007
522,1702256156700533145,2023-09-14 09:41:08,NemesisNemesi75,@EquinoxePROD On peut être connu des services de police sans avoir jamais eu affaire à la justice.,0,5,2,7
523,1702254714157441103,2023-09-14 09:35:24,NemesisNemesi75,"Un migrant congolais en situation irrégulière a frappé et brûlé avec un fer à repasser son ex-compagne mardi 12 septembre à Athis-Mons en Essonne.

Il l’a aussi obligée à se déshabiller tout en la filmant avec son téléphone et l’a ensuite et lui a coupé les cheveux.

Déjà connu…",834,1607,117,2558
524,1702221781409423813,2023-09-14 07:24:33,NemesisNemesi75,"“J’ai honte d’une Union européenne soumise à l’islam” dit au parlement européen l’eurodéputée italienne Silvia Sardone. 

Elle dénonce l’hypocrisie de l’institution qui fait régulièrement la promotion du voile islamique lors de ses événements et dans sa communication⬇️ https://twitter.com/NemesisNemesi75/status/1702221781409423813/video/1",895,2201,32,3128
525,1702005735142371645,2023-09-13 17:06:03,NemesisNemesi75,"Mouctar D., un migrant guinéen en situation irrégulière interpellé pour le viol d’une adolescente de 14 ans Gare du Nord dans le 10e arrondissement de Paris, vers 01h10, dans la nuit du mardi 12 au mercredi 13 septembre.

Mouctar D., 28 ans, est déjà connu au Traitement…",892,1743,113,2748
526,1701921032020320264,2023-09-13 11:29:28,NemesisNemesi75,"Hier, notre présidente @CordierAlice2 a été invitée par @CNEWS pour réagir sur la campagne de publicité de @Sephora en collaboration avec le collectif ""Les Hijabeuses "" qui promeut et souhaite le port du voile dans le football.

Pour rappel, le Conseil d’État a rejeté les… https://twitter.com/NemesisNemesi75/status/1701921032020320264/video/1",346,783,37,1166
527,1701883630241403050,2023-09-13 09:00:51,NemesisNemesi75,"""Malheureusement encore une fois des maghrébins et pourtant j’en suis aussi une et ça me déchire le cœur de devoir dire que ce soit des gens de ma communauté qui m’ont fait ça."" expliquait une jeune femme maghrébine en juillet dernier après avoir été agressée à cause de sa tenue… https://twitter.com/NemesisNemesi75/status/1701883630241403050/photo/1",2293,4826,366,7485
528,1701659326442512863,2023-09-12 18:09:33,NemesisNemesi75,@AngharadBen Une ;),0,19,1,20
529,1701654183865147659,2023-09-12 17:49:07,NemesisNemesi75,@Tdx33641 Merci 🙏,0,11,1,12
530,1701650669877264613,2023-09-12 17:35:09,NemesisNemesi75,"À Nice dans la nuit de lundi à mardi, une femme de 53 ans a été rouée de coups par un migrant angolais. 

Celui-ci a aussi sauté à pieds joints sur son visage. Elle est aujourd’hui entre la vie et la mort. https://twitter.com/NemesisNemesi75/status/1701650669877264613/photo/1",1431,2294,111,3836
531,1701553840892280967,2023-09-12 11:10:23,NemesisNemesi75,"🛑À Nice, un migrant angolais a sauté à pieds joints sur la tête d’une femme de 53 ans à plusieurs reprises et l’a rouée de coups la laissant pour morte.

 Une fois son méfait accompli, le suspect a pris la fuite dans les ruelles de la ville, laissant sa victime agonisante sur le…",2103,3827,430,6360
532,1701540492549214683,2023-09-12 10:17:21,NemesisNemesi75,@CordierAlice2 Il a aussi dit que des femmes portaient le voile non pas parce qu’elles étaient musulmanes mais juste pour ne pas avoir à se préoccuper de leur coiffure le matin 🙃.,3,40,3,46
533,1701502764998681079,2023-09-12 07:47:26,NemesisNemesi75,"« J’ai eu une pulsion sexuelle. Je voulais juste la voir nue. » C’est l’explication que Thomas V., 18 ans, a donné au tribunal pour avoir agressé sexuellement une joggeuse en juillet dernier dans l’Oise.

Sa victime a eu tellement peur de mourir qu’elle s’est jetée à l’eau pour…",550,1548,86,2184
534,1701244730774790380,2023-09-11 14:42:06,NemesisNemesi75,"Bon du coup vu que @Sephora France (et donc le groupe @LVMH dirigé par Bernard Arnault) ont décidé de promouvoir les tenues islamiques, on a préparé leur prochaine campagne de pub :

#BoycottSephora #BoycottLVMH https://twitter.com/NemesisNemesi75/status/1701244730774790380/photo/1",2159,4528,311,6998
535,1701229439135133779,2023-09-11 13:41:20,NemesisNemesi75,"Une femme de 37 ans dit avoir été violée par trois hommes dimanche soir en plein centre-ville de Bordeaux en marge du match Irlande-Roumanie.

Selon ses déclarations à la police, aidée par des policiers irlandais en renfort en ville, les trois hommes auraient « pénétré…",194,585,23,802
536,1701225121984266629,2023-09-11 13:24:10,NemesisNemesi75,"Donc maintenant @Sephora France fait la promotion des tenues islamiques en s’associant aux @leshijabeuses . 

Quelle grande marque française n’a pas encore cédé aux pressions communautaires ? 

Comment une marque prétendument féministe comme l’est @Sephora peut faire la promotion… https://twitter.com/NemesisNemesi75/status/1701225121984266629/video/1",1112,2344,503,3959
537,1701169847684485476,2023-09-11 09:44:32,NemesisNemesi75,"À Bobigny en Seine-Saint-Denis, un homme sous l’emprise de stupéfiants et armé s’était retranché chez lui avec sa conjointe et ses deux enfants. Il aura fallu parlementer pendant deux heures avant que le forcené finisse par se rendre, sans opposer de résistance.…",42,103,2,147
538,1701161839256539415,2023-09-11 09:12:43,NemesisNemesi75,"À Marseille, une femme de 24 ans est entre la vie et la mort : elle a reçu une balle dans la tête à la suite d’un tir de Kalachnikov.

Deux individus à scooter ont tiré au niveau d'un point de deal. L'une des balles a traversé un mur, touchant cette femme. Cette dernière serait…",522,1093,57,1672
539,1701141589731545134,2023-09-11 07:52:15,NemesisNemesi75,"Nos actions en hijabs ont manifestement inspiré nos sœurs espagnoles !  Vamos, chicas @HacerNacion ✊🏻 « HacerNacion: ⁉️ ¿Esta es la España que quieres?
 
➡️ Sustitución del pueblo español.
➡️ Imposición de delirios religiosos ajenos a nuestra tierra.
➡️ Inseguridad.
➡️ Odio y agresiones a las mujeres españolas.

🔄 Frente a la complicidad política y su modelo de España 2030, REMIGRACIÓN. https://twitter.com/HacerNacion/status/1700932354141815096/video/1 — https://twitter.com/hacernacion/status/1700932354141815096 »",308,872,15,1195
540,1701139877201334751,2023-09-11 07:45:27,NemesisNemesi75,"Sonia, une enseignante victime d'une agression sexuelle l’année dernière dans un collège du Lot par un élève explique : ""Je suis revenue le lendemain en pleurant"". Un élève de 6eme lui a mis un doigt dans l’anus pour « jouer au jeu de l’olive ». L’élève n’a pas subi de mesure…",915,1999,129,3043
541,1700970121408176562,2023-09-10 20:30:54,NemesisNemesi75,"Houari.D , 50 ans, a été arrêté après avoir agressé sexuellement une passagère du train de nuit, reliant Lourdes à Paris. Il a été interpellé lors de l’arrivée du train à destination. 

https://www.lefigaro.fr/faits-divers/une-femme-denonce-une-agression-sexuelle-dans-un-train-de-nuit-entre-lourdes-et-paris-20230909",174,292,7,473
542,1700967567865561391,2023-09-10 20:20:45,NemesisNemesi75,"Meaux : un homme sri-lankais, sous le coup d’une OQTF non appliquée et avec des  antécédents judiciaires du même ordre ( inscrit au fichier des délinquants sexuels), a agressé sexuellement la passagère d’un bus reliant Meaux à Paris. 

https://actu.fr/ile-de-france/meaux_77284/meaux-une-femme-agressee-dans-un-bus-par-le-voyageur-derriere-elle_60059744.html",298,391,12,701
543,1700963439764488552,2023-09-10 20:04:21,NemesisNemesi75,"Evreux : un algérien de 61 ans , en situation irrégulière sur le territoire français, a embrassé de force et touché la poitrine d’une femme enceinte sur la voie publique. 

https://www.paris-normandie.fr/id446790/article/2023-09-08/ivre-un-homme-en-situation-irreguliere-agresse-sexuellement-une-femme-enceinte",291,424,22,737
544,1700038875890974919,2023-09-08 06:50:27,NemesisNemesi75,"Clermont-Ferrand : Le père d’une lycéenne portant l’abaya menace de mort le proviseur du lycée Ambroise-Brugière. Le père de la jeune fille a été placé  jeudi en garde à vue avant d’EVENTUELLES poursuites judiciaires.

 https://www.lamontagne.fr/clermont-ferrand-63000/actualites/menace-de-mort-contre-un-proviseur-a-clermont-ferrand-le-pere-d-une-lyceenne-en-abaya-en-garde-a-vue_14367295/",226,462,31,719
545,1700035154893262863,2023-09-08 06:35:40,NemesisNemesi75,"Mardi 5 septembre à Poitiers, un homme de 42 ans a été interpellé pour avoir poignardé sa femme à plusieurs reprises. Sa conjointe, une femme âgée de 34 ans a été transportée à l'hôpital très gravement blessée. Une enquête pour tentative de meurtre sur conjoint a été ouverte.…",30,97,0,127
546,1699684940978258095,2023-09-07 07:24:03,NemesisNemesi75,"64 % des Français favorables à l’arrêt de l’immigration extra-européenne. 

Et même chez les sympathisants @EELV et de @FranceInsoumise on y est  favorable à près de 40%. Surprenant. 

https://www.cnews.fr/france/2023-09-07/sondage-64-des-francais-favorables-larret-de-limmigration-extra-europeenne-en https://twitter.com/NemesisNemesi75/status/1699684940978258095/photo/1",69,223,7,299
547,1699680403387220109,2023-09-07 07:06:01,NemesisNemesi75,"À Marseille lundi soir, une femme a été attaquée au couteau par son ex-compagnon sur le Vieux-Port.

L'auteur des coups âgé d’une vingtaine d’années a été placé en garde à vue. 

https://www.laprovence.com/article/faits-divers-justice/3158317852978615/marseille-une-femme-attaquee-au-couteau-par-son-ex-compagnon-sur-le-vieux-port",45,100,1,146
548,1699679506473034183,2023-09-07 07:02:27,NemesisNemesi75,"Â la Réunion mardi 5 septembre, une jeune femme de 29 ans enceinte a été prise en charge après de fortes contractions survenues après avoir été la cible d’une agression physique dimanche. Une agression qui aurait été commise par son compagnon.
Malheureusement, elle a dû accoucher…",112,278,16,406
549,1699678232394482029,2023-09-07 06:57:23,NemesisNemesi75,"«J’ai touché sexuellement une petite fille, on m’a filmé et maintenant on me fait chanter. Ils m’ont demandé 200 000 €. Je leur en ai déjà donné 15 000 et ils veulent que je leur achète une Mercedes. »

Un homme de 69 ans a été jugé par le tribunal correctionnel de Nantes, en…",241,612,51,904
550,1699673073601941526,2023-09-07 06:36:53,NemesisNemesi75,"""Moi il ne m'a pas sodomisé, il ne m'a pas mis de cuillère en bois dans le vagin, il ne m'a pas laissé des heures dans la forêt. Je me dis que j’ai eu de la chance car il l’a fait à mes co-victimes""

C’est le témoignage horrifiant d’Angelique Cauchy, violée près de 400 fois par…",1338,2890,175,4403
551,1699668499369517295,2023-09-07 06:18:43,NemesisNemesi75,Une femme agressée sexuellement à la bibliothèque François Mitterand filme ses agresseurs : https://twitter.com/NemesisNemesi75/status/1699668499369517295/video/1,1902,3670,437,6009
552,1699495147149337040,2023-09-06 18:49:52,NemesisNemesi75,"Merci au @Le_Figaro qui vient remettre un peu de sérieux dans le journalisme français . 

Le journal confirme : les chiffres du ministère de l'Intérieur sur l’année 2022 montre bien que la ville de Lille et la ville de Saint-Denis sont les championnes de l’insécurité. Notre…",762,1848,27,2637
553,1699436410439164278,2023-09-06 14:56:28,NemesisNemesi75,@Issam785Djellal @DamienRieu Mais oui bien sur,0,0,2,2
554,1699436110017953856,2023-09-06 14:55:17,NemesisNemesi75,@solsol36451159 @franoisedupon17 Force est de constater que la Hongrie qui est pourtant dans l’UE y arrive pourtant très bien.,3,21,6,30
555,1699365950733050017,2023-09-06 10:16:30,NemesisNemesi75,Les politiques qui veulent légiférer sur l’abaya mais pas sur l’immigration être comme : https://twitter.com/NemesisNemesi75/status/1699365950733050017/video/1,679,2452,46,3177
556,1699356474797883843,2023-09-06 09:38:50,NemesisNemesi75,"Interpellations, plaintes, le journal Libération qui juge notre action ""islamophobe""... on vous résume dans cette vidéo notre action de ce week-end à la braderie de Lille  ⬇️

https://youtu.be/t8ga0kTiqOQ?si=Ido4xZ0ZWKCpflsD",160,363,12,535
557,1699351124644331797,2023-09-06 09:17:35,NemesisNemesi75,"Pour la @lavoixdunord, nos banderoles contre le salafisme étaient « contre l’islam». Qu’essaient nous dire leurs journalistes ? Qu’il’ n’y aurait donc pas de différences entre les deux ? 🙃🙃🙃 « CordierAlice2: « La police a interpellé une militante ayant déployé des banderoles extrémistes contre l’islam »

@lavoixdunord confond visiblement islam et salafisme. 
C’est fou de faire de tels raccourcis. https://twitter.com/CordierAlice2/status/1699319048763236828/photo/1 — https://twitter.com/cordieralice2/status/1699319048763236828 »",190,492,14,696
558,1699047080121995417,2023-09-05 13:09:25,NemesisNemesi75,"Du coup @MartineAubry, vous allez porter plainte contre le lycée Averroès aussi ou promouvoir des textes qui appellent à la peine de mort en cas d’apostasie est désormais dans « l’ADN des Lillois » ? 🧐 « MartineAubry: Vous n’avez pas de place dans notre ville, avec ces idées contraires à l’ADN des Lillois. Nous avons porté plainte. — https://twitter.com/martineaubry/status/1698690717168607353 »",595,1517,28,2140
559,1698734618738864302,2023-09-04 16:27:48,NemesisNemesi75,"Donc Madame @MartineAubry porte plainte contre nous. C’est plus facile de porter plainte contre nous que d’agir pour la sécurité des lilloises et des lillois visiblement. C’est les lillois qui devraient porter plainte contre vous pour votre inaction. « MartineAubry: Vous n’avez pas de place dans notre ville, avec ces idées contraires à l’ADN des Lillois. Nous avons porté plainte. — https://twitter.com/martineaubry/status/1698690717168607353 »",1078,3153,136,4367
560,1698635663359308109,2023-09-04 09:54:35,NemesisNemesi75,"⚠️Pour rappel, défendre nos convictions n’a PAS de prix mais le militantisme lui a un COÛT : 

Nos militantes sont bénévoles et beaucoup d’entre elles sont étudiantes. Elles prennent des RISQUES pour défendre les françaises. Elles n’ont pas les moyens de payer des frais d’avocats…",380,813,33,1226
561,1698607342705594725,2023-09-04 08:02:03,NemesisNemesi75,"« La liste des interdits qui frappent les femmes depuis l'accession au pouvoir des talibans est interminable et vertigineuse: interdiction d'étudier après la primaire, interdiction de sortir sans être accompagnée d'un mahram (gardien), interdiction de montrer la moindre partie de…",562,1208,59,1829
562,1698603442778873960,2023-09-04 07:46:33,NemesisNemesi75,"Merci @Valeurs 

https://www.valeursactuelles.com/societe/le-collectif-nemesis-deploie-une-banderole-contre-limmigration-a-la-braderie-de-lille",104,326,6,436
563,1698591400525467844,2023-09-04 06:58:42,NemesisNemesi75,@PlacuK Il était en détention provisoire depuis 2018 et a été remis en liberté à peine un an plus tard et il est finalement rentré en prison en juin 2023 pour ressortir deux mois plus tard…,64,272,6,342
564,1698589372772200885,2023-09-04 06:50:39,NemesisNemesi75,@nostalgia_d Oui nous sommes au courant mais la phrase a visiblement vraiment été prononcée par un homme accusé de viol. Nous aimerions donc en savoir plus sur cet article.,4,95,1,100
565,1698588498591150217,2023-09-04 06:47:10,NemesisNemesi75,"”Je n’ai pas violé cette fille. Le viol, c’est quand on ne veut pas, et moi je voulais”

Nous sommes très intriguées par le titre LUNAIRE de cet article d’un journal belge. Si un abonné à ce journal pouvait nous faire un résumé de cette affaire nous lui en serions reconnaissantes…",293,902,38,1233
566,1698585564142809375,2023-09-04 06:35:31,NemesisNemesi75,"@filante627111 Mais ou avez vu/lu que violeur d’Oceane était un arabe ? 

Lisez nos posts, nous avons parlé de tous les agresseurs que vous avez mis en photo et récemment la femme policière tuée aussi.

Cessez de vous humilier ainsi ca sera mieux pour vous.",3,18,1,22
567,1698584159252316437,2023-09-04 06:29:56,NemesisNemesi75,"En juin 2022, Océane Bourdin, 21 ans, se suicide après avoir subi plusieurs viols.
Elle laissera ce mot à ses parents:

«Je suis morte depuis le 10 février (date du viol), vous n'auriez rien pu faire pour moi.» 

Yvan et Sandra Bourdin, les parents d’Oceane, reprochent à la… https://twitter.com/NemesisNemesi75/status/1698584159252316437/photo/1",2536,5164,354,8054
568,1698579460251856981,2023-09-04 06:11:16,NemesisNemesi75,"Bon, c’est sûrement pas aussi grave qu’une banderole accrochée à la façade du Carlton de Lille mais quand même :

Le 25 août 2023, un homme de 36 ans, condamné en août 2018 à 9 ans de prison pour le viol de sa voisine de palier de 17 ans à Saint-Malo, a obtenu sa remise en…",972,2156,52,3180
569,1698350529636692473,2023-09-03 15:01:34,NemesisNemesi75,"Donc le journal @libe trouve « islamophobe » de s’indigner du fait que dans un lycée musulman en FRANCE, on donne à lire à des élèves des textes qui expliquent que les femmes ne doivent pas être auscultées par des hommes médecins, que la mixité au travail est interdite ou que… « libe: Deux banderoles racistes, un selfie avec Darmanin et trois gardes à vue : c’est le bilan d’un happening islamophobe réalisé hier par les identitaires féminines du collectif Némésis à Lille. https://www.liberation.fr/politique/lille-les-identitaires-des-nemesis-deploient-deux-banderoles-racistes-et-finissent-en-garde-a-vue-20230903_42NCPWWUKRCE5MBUGLHYVQYQOY/?utm_medium=Social&xtor=CS7-51-&utm_source=Twitter#Echobox=1693745439 — https://twitter.com/libe/status/1698317682959867999 »",837,2416,86,3339
570,1698257542093103151,2023-09-03 08:52:04,NemesisNemesi75,"@abcdeidf @borislemodeste @GWGoldnadel Ah parce que si c’est un lycée privé musulman  ça va ? On a le droit d’y enseigner que l’apostasie doit être punie de mort ? Privée sous contrat ou pas, nous sommes encore en France, merci.",4,42,1,47
571,1698234565725245892,2023-09-03 07:20:46,NemesisNemesi75,@Delphin88004699 Merci beaucoup Delphine !,0,3,1,4
572,1698230901719617852,2023-09-03 07:06:13,NemesisNemesi75,"Beaucoup d’entre vous nous demandent comment nous aider. Vous pouvez le faire par deux moyens principaux :

➡️En relayant nos posts avec les #LiberezNemesis 

➡️En nous aidant financièrement en cliquant sur le lien en bio de notre twitter. Notre adresse Paypal est…",419,650,25,1094
573,1698223353046196636,2023-09-03 06:36:13,NemesisNemesi75,"⚠️ Pour une banderole déployée SANS VIOLENCES NI DÉGRADATIONS à l’hôtel Carlton de Lille, 3 de nos militantes sont TOUJOURS EN GAV !⚠️

Cette situation est absolument RIDICULE. 

#AssaTraoré qui organisait pourtant des manifestations illégales n’a JAMAIS eu droit au même… https://twitter.com/NemesisNemesi75/status/1698223353046196636/photo/1",2831,6035,437,9303
574,1698218980874350899,2023-09-03 06:18:51,NemesisNemesi75,"@ROWA_ZARLE @PeterColumns Il n’y a pas de mensonge : le lycée musulman Averroès de Lille donne à lire à ses élèves des textes salafistes qui expliquent que la mixité femmes/hommes est prohibée, qu’une femme ne doit pas être auscultée par un homme médecin ou encore que l’apostasie est puni de mort .…",2,12,1,15
575,1698217978016231889,2023-09-03 06:14:51,NemesisNemesi75,"@borislemodeste @GWGoldnadel Le message est clair. Mais le sujet que nous dénonçons est peu connu mais c’est un problème bien réel :

Le lycée musulman Averroès de Lille donne à lire à ses élèves des textes salafistes qui expliquent que la mixité femmes/hommes est prohibée, qu’une femme ne doit pas être…",52,109,5,166
576,1698203956399268231,2023-09-03 05:19:08,NemesisNemesi75,"@joe_bruad @Occidentis1 @AlexDeRubempre Les preuves : https://www.lefigaro.fr/actualite-france/au-lycee-averroes-de-lille-lectures-salafistes-et-petits-arrangements-entre-amis-20230516

Ce lycée donne à lire à ses élèves des textes salafistes qui expliquent que la mixité femmes/hommes est prohibée, qu’une femme ne doit pas être auscultée par un homme médecin ou encore que l’apostasie est puni de mort .

Inacceptable dans un…",1,4,2,7
577,1698091525190643936,2023-09-02 21:52:23,NemesisNemesi75,"@PDuhring @CordierAlice2 Vu qu’apparemment tu n’as pas tout compris on t’aide:

« NemesisNemesi75: Notre présidente @CordierAlice2 a interpellé @GDarmanin à la #BraderieDeLille concernant la non application des OQTF.

Malheureusement, elle n’aura évidemment pas de réponse 🤡 https://twitter.com/NemesisNemesi75/status/1697958511882203275/video/1 — https://x.com/nemesisnemesi75/status/1697958511882203275 »",1,20,4,25
578,1698037838917329166,2023-09-02 18:19:03,NemesisNemesi75,"Visiblement @GDarmanin n’a pas apprécié de se faire interpeller par notre présidente @CordierAlice2 à la Braderie de Lille. Serait-ce la raison du placement en GAV d’Alice Cordier avec d’autres militantes ?

#LiberezAlice #LiberezNemesis #BraderieDeLille « NemesisNemesi75: Notre présidente @CordierAlice2 a interpellé @GDarmanin à la #BraderieDeLille concernant la non application des OQTF.

Malheureusement, elle n’aura évidemment pas de réponse 🤡 https://twitter.com/NemesisNemesi75/status/1697958511882203275/video/1 — https://twitter.com/nemesisnemesi75/status/1697958511882203275 »",873,1591,106,2570
579,1698034875326984572,2023-09-02 18:07:16,NemesisNemesi75,#LiberezNemesis #LiberezAlice #BraderieDeLille « NemesisNemesi75: 🔴Au moins 3 de nos militantes dont @CordierAlice2 viennent de se faire interpeller et viennent de partir en GAV pour pour avoir déployé une banderole à l’hôtel Carlton à la #BraderieDeLille 🔴 https://twitter.com/NemesisNemesi75/status/1698018293565501883/photo/1 — https://twitter.com/nemesisnemesi75/status/1698018293565501883 »,274,555,17,846
580,1698018296367354119,2023-09-02 17:01:24,NemesisNemesi75,"Les militantes du Collectif Némésis etaient présentes aujourd'hui à la #BraderieDeLille pour mener plusieurs actions dénonçant l’insécurité grandissante à Lille et son islamisation.

En effet, dans le lycée musulman Averroès, on a plus peur de proner des enseignements totalement…",285,635,28,948
581,1698018293565501883,2023-09-02 17:01:23,NemesisNemesi75,🔴Au moins 3 de nos militantes dont @CordierAlice2 viennent de se faire interpeller et viennent de partir en GAV pour pour avoir déployé une banderole à l’hôtel Carlton à la #BraderieDeLille 🔴 https://twitter.com/NemesisNemesi75/status/1698018293565501883/photo/1,1518,3286,272,5076
582,1698010548535750761,2023-09-02 16:30:36,NemesisNemesi75,"« L’idylle » entre @GDarmanin et nous et si grande qu’il nous a envoyé balader , la preuve ici: https://x.com/nemesisnemesi75/status/1697958511882203275?s=46

« L’idylle » entre @GDarmanin et « l’extrême-droite » est si grande qu’il passe son temps à dissoudre des groupuscules « d’extrême-droite » alors que pour la… « ArnaultRaphael: L’idylle entre le gvt et l’ED se poursuit à merveille… Après que Macron ait poussé la chansonnette avec des fascistes en pleine rue à Paris. Voilà que Gérald Darmanin se prend en photo, tout sourire, avec Alice Cordier (militante d’extrême-droite issue des mvts royalistes).

⤵️ https://twitter.com/ArnaultRaphael/status/1698005280838103237/photo/1 — https://twitter.com/arnaultraphael/status/1698005280838103237 »",236,876,33,1145
583,1697958511882203275,2023-09-02 13:03:50,NemesisNemesi75,"Notre présidente @CordierAlice2 a interpellé @GDarmanin à la #BraderieDeLille concernant la non application des OQTF.

Malheureusement, elle n’aura évidemment pas de réponse 🤡 https://twitter.com/NemesisNemesi75/status/1697958511882203275/video/1",2361,5665,666,8692
584,1697931472487731440,2023-09-02 11:16:23,NemesisNemesi75,"Le saviez-vous ? Avec 26 faits pour 10 000 habitants, Lille est la championne des violences sexuelles en France.

➡️Une augmentation de 33 % a d’ailleurs été constaté entre 2021 et 2022

Que fait @MartineAubry ?

#LilleDevientSaintDenis #BraderieDeLille https://twitter.com/NemesisNemesi75/status/1697931472487731440/photo/1",899,1716,92,2707
585,1697919733058748683,2023-09-02 10:29:44,NemesisNemesi75,"#LilleDevientSaintDenis la faute à @MartineAubry ? 

Aujourd’hui nos militantes étaient présentes à la #BraderieDeLille pour alerter sur l’état désastreux de la sécurité de cette ville :

Avec 106,35 crimes et délit pour 1000 habitants, Lille réussit l'exploit de passer devant… https://twitter.com/NemesisNemesi75/status/1697919733058748683/video/1",1281,3074,127,4482
586,1697867517534887987,2023-09-02 07:02:15,NemesisNemesi75,"Edit: Dans cet affaire, l’homme interpellé pour le viol d’une femme à la Roche-sur-Yon est un Algérien 🇩🇿 en situation irrégulière. Encore une fois…

Le suspect a indiqué via son avocate Meriem Abkoui qu’il est « très croyant et avait peur que son frère le juge pour cette… « NemesisNemesi75: Dans la nuit du samedi 12 au dimanche 13 août, une femme a été violée, en pleine rue, à la sortie d’une boîte de nuit de La Roche-sur-Yon (Vendée). Ce mercredi 30 août, un homme, âgé de 21 ans, a été mis en examen et incarcéré.

https://www.ouest-france.fr/faits-divers/violence-sexuelle/viol/une-jeune-femme-violee-en-pleine-rue-a-la-sortie-dune-boite-de-nuit-en-vendee-un-homme-incarcere-e6c0e34a-4739-11ee-be1c-14e3ad931255 — https://twitter.com/nemesisnemesi75/status/1697153222689816947 »",1044,1983,111,3138
587,1697865584405356552,2023-09-02 06:54:34,NemesisNemesi75,"À Garges-les-Gonesse dans le 95, un Pakistanais en situation irrégulière a été interpellé. 

Il est suspecté du meurtre de Saman Abbas, une jeune fille mineure après son refus d’un mariage forcé en Italie. 

https://www.ilmessaggero.it/roma/metropoli/saman_abbas_padre_arrestato_in_italia_dopo_estradizione_dal_pakistan-7606508.html",469,711,30,1210
588,1697542856297103411,2023-09-01 09:32:10,NemesisNemesi75,@pierrequirou Nous avouons : nous avons ri 🥲,1,56,4,61
589,1697541859642663349,2023-09-01 09:28:12,NemesisNemesi75,"Un jour normal à la Guillotière à #Lyon: un homme maghrébin pète les plombs contre une femme en enlevant son pantalon et en hurlant. Visiblement il parle de son pénis ? 🤡

(vidéo d’une abonnée, merci à elle) https://twitter.com/NemesisNemesi75/status/1697541859642663349/video/1",1106,1692,332,3130
590,1697488665507762503,2023-09-01 05:56:50,NemesisNemesi75,"Lot-et-Garonne : un mineur de 17 ans incarcéré pour le viol d’une femme de 36 ans alors que celle-ci se reposait sur un canapé lors d’une soirée. 

Déjà connu pour des faits similaires, l’individu a été placé en garde à vue et présenté au parquet, jeudi 31 août.…",412,709,31,1152
591,1697487444436832709,2023-09-01 05:51:59,NemesisNemesi75,"Montpellier : Trois jeunes femmes séquestrées et forcées à se prostituer libérées par le RAID jeudi matin.

Les trois victimes étaient forcées à se prostituer depuis plusieurs semaines par un couple, dont l’homme était porteur d’une arme. 

Le couple a été interpellé.…",622,1148,37,1807
592,1697485079805669528,2023-09-01 05:42:35,NemesisNemesi75,"Comme quoi, quand on veut on peut. Bravo à la Belgique qui, au moins pour une durée indéterminée, ne se laisse pas dicter sa conduite par des associations pro-migrants. 

https://amp.rfi.fr/fr/europe/20230831-asile-la-belgique-suspend-l-accueil-des-hommes-seuls-pour-privilégier-les-familles https://twitter.com/NemesisNemesi75/status/1697485079805669528/photo/1",440,1067,35,1542
593,1697275189048803811,2023-08-31 15:48:33,NemesisNemesi75,"@panam99 @CordierAlice2 @oncle_sam4 On a littéralement parlé de toutes les personnes que vous avez cité à l’exception de Morandini puisque ca ne concerne pas des femmes et que notre domaine c’est les violences faites aux femmes . Mais bon c’est pas grave, continuez à vous ridiculiser.",2,20,4,26
594,1697268836318236872,2023-08-31 15:23:18,NemesisNemesi75,"«Tôt ou tard, il faudra que les femmes à Paris vivent et prennent les précautions qu’on prend ailleurs » explique le journaliste Vincent Hervouët sur le plateau de @CNEWS en prenant l’exemple de villes comme Casablanca ou le Caire.

Un futur glaçant. https://twitter.com/NemesisNemesi75/status/1697268836318236872/video/1",1313,2518,235,4066
595,1697239836132827223,2023-08-31 13:28:04,NemesisNemesi75,"@joe_bruad Oui c’est exactement ça. En effet, rien n’indique que dans les 38% restants qui ont la nationalité française, la proportion d’hommes issus de l’immigration.",11,50,2,63
596,1697237898200801325,2023-08-31 13:20:22,NemesisNemesi75,"En 2020, 57 000 plaintes pour violences sexuelles ont été enregistrées dans les transports en commun. Soit 156 plaintes par jour, près de deux fois et demi de plus qu’en 2011. 

Selon les chiffres ministériels, en Ile-de-France, 62% des auteurs sont étrangers, et 29% des auteurs… https://twitter.com/NemesisNemesi75/status/1697237898200801325/photo/1",374,624,32,1030
597,1697228459121033258,2023-08-31 12:42:52,NemesisNemesi75,"Une policière hors service tuée à coups de batte de baseball en pleine rue ce jeudi matin à Valgelon-La Rochette, près de Chambéry.

Son ex-mari, un homme de 61 ans est le principal suspect. Déjà connu des services de police, il aurait pris la fuite en voiture.…",261,544,25,830
598,1697174814610309120,2023-08-31 09:09:42,NemesisNemesi75,@doramoutot Lunaire,1,26,0,27
599,1697162482467373330,2023-08-31 08:20:42,NemesisNemesi75,@Los__Muros__78 vous savez lire un article? Quand on ne met pas le nom de l’agresseur c’est qu’on ne le connait pas tout simplement sinon il est systématiquement donné,0,17,0,17
600,1697160547022536760,2023-08-31 08:13:00,NemesisNemesi75,"Un viol en réunion choque l’Italie : Francesca, une femme de 19 ans, a été violée par un groupe de 7 hommes dans un parc de la ville de Palerme en Sicile à la sortie d’une soirée en boite de nuit.

En boîte de nuit, l’un aurait alors déclaré : « Fais-la boire, après on verra ce…",727,1496,162,2385
601,1697158105170063670,2023-08-31 08:03:18,NemesisNemesi75,"Une femme de 57 ans née à Bagdad en Irak retrouvée morte sur la voie publique sur un chemin de la commune de Chambray-les-Tours (Indre-et-Loire)

D’après des informations recueillies sur les lieux du drame, la victime aurait succombé après avoir été rouée de coups par son mari.…",515,801,46,1362
602,1697157195157180842,2023-08-31 07:59:41,NemesisNemesi75,"Hakan C., un dirigeant d’entreprise de 56 ans avait été condamné à du sursis pour des violences sur sa première femme. 

Sa deuxième épouse avait porté plainte contre lui pour viol. Et il vient d’être écroué, soupçonné d’avoir tué sa troisième compagne Nacira qui avait 52 ans.…",223,404,18,645
603,1697156287459463312,2023-08-31 07:56:05,NemesisNemesi75,"Le 29 juin 2023, Bruno Boudoux, 55 ans, a été condamné à onze ans de réclusion criminelle pour l’agression sexuelle de sa fille et le viol de son amie à Ballan-Miré entre 2015 et 2016. 

Il a demandé à être libéré dans l’attente de son procès en appel mais sa demande a été…",58,216,4,278
604,1697155070926770638,2023-08-31 07:51:15,NemesisNemesi75,"Un homme de 83 ans est jugé pour des agressions sexuelles commises sur une dame de 96 ans atteinte de démence, entre septembre 2022 et mars 2023. 

Tous deux résidaient en maison de retraite à Yutz en Moselle. Le personnel a donné l’alerte. La victime est aujourd’hui décédée.…",39,124,2,165
605,1697154264781451552,2023-08-31 07:48:02,NemesisNemesi75,"Lundi 28 août, une femme de 30 ans a été violée alors qu’elle faisait son jogging à Fréjus dans le Var.

La joggeuse a soudainement été agrippée par un homme également âgé d’une trentaine d’années. Sous la menace, ce dernier a imposé à la victime une fellation dans un coin…",351,554,26,931
606,1697153222689816947,2023-08-31 07:43:54,NemesisNemesi75,"Dans la nuit du samedi 12 au dimanche 13 août, une femme a été violée, en pleine rue, à la sortie d’une boîte de nuit de La Roche-sur-Yon (Vendée). Ce mercredi 30 août, un homme, âgé de 21 ans, a été mis en examen et incarcéré.

https://www.ouest-france.fr/faits-divers/violence-sexuelle/viol/une-jeune-femme-violee-en-pleine-rue-a-la-sortie-dune-boite-de-nuit-en-vendee-un-homme-incarcere-e6c0e34a-4739-11ee-be1c-14e3ad931255",137,233,4,374
607,1696956923390652623,2023-08-30 18:43:53,NemesisNemesi75,"Richard Dewitte, l’interprète de la célèbre chanson, « J’ai encore rêvé d’elle » sera jugé le 18 septembre prochain par le tribunal correctionnel de Meaux, pour corruption de mineure et propositions sexuelles faites à une mineure. 

Il a été piégé sur Internet par un gendarme qui… https://twitter.com/NemesisNemesi75/status/1696956923390652623/photo/1",180,332,41,553
608,1696882021056786769,2023-08-30 13:46:15,NemesisNemesi75,@HadrienClouet Pouvez-vous avancer des arguments qui ne sont pas de la pure malhonnêteté intellectuelle ?,18,356,5,379
609,1696868053751877641,2023-08-30 12:50:44,NemesisNemesi75,@ArquetteHenri @HadrienClouet évidemment que ça ne fonctionne pas,0,40,1,41
610,1696861394862272861,2023-08-30 12:24:17,NemesisNemesi75,"C’est vrai que les immigrées japonaises  ont beaucoup troublé l’ordre public en essayant d’imposer toujours plus le shintoïsme à l’école en France ces derniers temps @HadrienClouet … « HadrienClouet: L'interdiction du kimono, j'imagine que ce sera pour la rentrée 2024 ? — https://twitter.com/hadrienclouet/status/1696230030622244989 »",536,2091,49,2676
611,1696859308594516062,2023-08-30 12:15:59,NemesisNemesi75,@CordierAlice2 Ce degré de mauvaise foi stratosphérique…,1,31,0,32
612,1696820079499849863,2023-08-30 09:40:07,NemesisNemesi75,"Pensez-vous possible qu’une association qui aide des clandestins à rester en France même quand ceux-ci  sont sous OQTF et ont commis des crimes puisse recevoir de l’argent public ? 

Et bien c’est le cas à Nantes où la mairie a alloué plus de 55 000 euros d’argent public à… https://twitter.com/NemesisNemesi75/status/1696820079499849863/photo/1",1687,2835,160,4682
613,1696782111255019576,2023-08-30 07:09:14,NemesisNemesi75,"Pour justifier le viol d’une femme quinquagénaire dans un immeuble à Paris, Ramy Z., s’est dit «frustré par le refus de la victime de partager l'ascenseur avec lui». 

L’homme de 25 ans qui a étranglé sa victime jusqu’à ce qu’elle tombe dans les pommes mercredi 23 août est bien…",601,1030,47,1678
614,1696776898947252228,2023-08-30 06:48:31,NemesisNemesi75,"C’était la 17eme fois qu’un homme de 77 ans était condamné pour exhibition sexuelle sur mineure. Sa première condamnation date de 1992. 

Les derniers faits, qu’il reconnaît, ont eu lieu le 4 juillet 2023. Il venait alors de purger sa dernière peine de prison le 23 juin 2023.…",176,425,13,614
615,1696533966755594453,2023-08-29 14:43:12,NemesisNemesi75,"En Seine-et-Marne, une femme de 80 ans frappée à coups de poings et dépouillée à son domicile lors d’un violent cambriolage. 

L’agresseur qui aurait entre 25 et 30 ans était masqué au moment des faits. Il a également menacé les voisins de la femme de 80 ans alors qu’ils…",241,572,35,848
616,1696460467357581569,2023-08-29 09:51:08,NemesisNemesi75,"L’occasion de rappeler que, si les viols collectif existaient en France avant l’immigration, notre politique migratoire a fait exploser leur nombre.

Le calvaire au Bangladesh d’Amelie Nothomb est aujourd’hui dans les caves et les cages d’escaliers de nos cités françaises.",114,488,12,614
617,1696453034824388826,2023-08-29 09:21:36,NemesisNemesi75,"« Une chute dans les escaliers »

C’est l’explication qu’a donné un homme de 56 ans pour expliquer la mort et les traces de coups retrouvés sur sa compagne de 53 ans le samedi 26 août à Sucy-en-Brie.

L’homme est soupçonné d’avoir tué da compagne et il a été placé en garde à vue.…",61,216,4,281
618,1696446504955760933,2023-08-29 08:55:39,NemesisNemesi75,"Amélie Nothomb, la célèbre romancière se livre sur le viol collectif par 4 hommes qu’elle a subi au Bangladesh quand elle avait 12 ans dans les années 70 : https://twitter.com/NemesisNemesi75/status/1696446504955760933/video/1",544,1201,84,1829
619,1696080950197649467,2023-08-28 08:43:04,NemesisNemesi75,"En Suisse, 53% des suspects de violences domestiques sont des étrangers. Une très nette surreprésentation des étrangers dans ce domaine puisqu’ils représentent 25% de la population suisse.

➡️Les résultats d'études réalisées au sein de la population font aussi état d'une… https://twitter.com/NemesisNemesi75/status/1696080950197649467/photo/1",203,389,8,600
620,1696048400922243552,2023-08-28 06:33:44,NemesisNemesi75,"Un homme de 42 ans dont le casier judiciaire comporte 26 mentions à nouveau condamné pour violences conjugales.

Il est condamné à 14 mois d’emprisonnement seulement, dont 12 avec sursis probatoire.

https://www.ouest-france.fr/normandie/colombelles-14460/un-quarantenaire-au-lourd-passe-judiciaire-condamne-pour-violences-conjugales-a-colombelles-113669ea-437c-11ee-9f1c-5079ba01e1f8",155,264,6,425
621,1696046544544268694,2023-08-28 06:26:21,NemesisNemesi75,"Lundi 21 août à Saint-Etienne, une femme de 63 ans a été tuée dans un bar par son compagnon de 71 ans qui n’a pas supporté l’annonce d’une séparation. 

L’homme a fait feu à deux reprises sur la victime avec une arme de poing dans un bar où ils avaient rendez-vous.…",48,185,4,237
622,1696042960205320644,2023-08-28 06:12:07,NemesisNemesi75,"Le tueur de Dana, qui avait déjà été condamné pour le meurtre de sa première femme en 1996 s’appelle Raphaël Tombouctou. Il est de nationalité franco-algérienne 🇩🇿

https://actu.fr/bourgogne-franche-comte/vaux-les-saint-claude_39547/vaux-les-saint-claude-qui-etait-raphael-t-le-meurtrier-presume-deja-condamne-pour-feminicide_60008004.html https://twitter.com/NemesisNemesi75/status/1696042960205320644/photo/1 « NemesisNemesi75: Dana, une jeune femme originaire de Lettonie et son conjoint ont été retrouvés morts à Vaux-les-Saint-Claude. 

L'homme qui aurait tué sa conjointe avait un lourd passé judiciaire : il était connu de la justice pour avoir été condamné en 1996 pour des faits de meurtre. Il avait… — https://twitter.com/nemesisnemesi75/status/1695344861912674437 »",405,594,37,1036
623,1696041560310186324,2023-08-28 06:06:33,NemesisNemesi75,"Vous croyez être à l’abri dans un commissariat? Ça n’est pas le cas:

Dimanche dernier, un homme de 31 ans a agressé sa compagne au couteau au commissariat à Saint-Chamond, alors qu’elle était venue porter plainte pour des violences conjugales qu’il lui avait fait subir au…",503,1305,39,1847
624,1696039204755534062,2023-08-28 05:57:11,NemesisNemesi75,"Jeudi 24 août, un migrant libyen sois OQTF depuis plus d’un an était jugé au tribunal de Saint-Nazaire qui l’a condamné à seulement six mois de prison avec sursis pour exhibitionnisme. 

Il avait exhibé son sexe et s’était masturbé à deux reprises devant une serveuse au Pouliguen…",157,410,16,583
625,1695754556313858223,2023-08-27 11:06:06,NemesisNemesi75,"Sète: Une femme de ménage, a été suivie et agressée par un clandestin somalien. Celui-ci réclamait une relation sexuelle et avait saisi le bras de la victime en lui demandant de le suivre. L’intervention des pêcheurs lui a permis d’éviter le pire. 

https://www.midilibre.fr/2023/08/27/agression-de-nuit-a-sete-une-femme-de-menage-echappe-de-justesse-a-un-inconnu-11414786.php",1148,2146,111,3405
626,1695738062163136910,2023-08-27 10:00:33,NemesisNemesi75,"Tours: Deux jeunes hommes de 17 ans, de « type africain et nord africain » et déjà connus de la justice, arrêtés pour proxénétisme aggravé sur une jeune fille de 14 ans. 

https://www.lefigaro.fr/faits-divers/tours-deux-mineurs-ecroues-pour-avoir-sequestre-et-prostitue-une-jeune-fille-de-14-ans-20230826",668,953,34,1655
627,1695451503161421985,2023-08-26 15:01:52,NemesisNemesi75,"📣 Appel à témoignages : -STRASBOURG- 

Avez-vous déjà été témoin ou victime
de harcèlement/agression dans les
rues de Strasbourg ? 

Vous pouvez témoigner en réponse à cette publication. 👇🏻",67,104,7,178
628,1695367993851621602,2023-08-26 09:30:02,NemesisNemesi75,"Au cas où : ceci est de l’humour, un MONTAGE, une blague, une parodie…",3,52,0,55
629,1695358107180810443,2023-08-26 08:50:45,NemesisNemesi75,"«On a pas signé des accords d’invasion (…) La première question à poser c’est : on s’en va quand ?» , « Parce que c’est seulement notre pays » : qui aurait cru que @JLMelenchon serait un jour d’accord avec nous sur l’immigration 🤡 : https://twitter.com/NemesisNemesi75/status/1695358107180810443/video/1",201,772,27,1000
630,1695346975988654427,2023-08-26 08:06:31,NemesisNemesi75,"Vendredi 25 août, André Blanche, un homme âgé de 83 ans, a tenté de tuer sa femme. Il a été placé à la maison d’arrêt de Nantes.

https://www.ouest-france.fr/pays-de-la-loire/saint-vincent-sur-jard-85520/il-avait-tente-de-tuer-sa-femme-en-vendee-un-octogenaire-mis-en-examen-et-incarcere-ceadb5de-4352-11ee-ac21-50173a5f08fe",19,37,4,60
631,1695344861912674437,2023-08-26 07:58:07,NemesisNemesi75,"Dana, une jeune femme originaire de Lettonie et son conjoint ont été retrouvés morts à Vaux-les-Saint-Claude. 

L'homme qui aurait tué sa conjointe avait un lourd passé judiciaire : il était connu de la justice pour avoir été condamné en 1996 pour des faits de meurtre. Il avait…",153,460,31,644
632,1695108549729239132,2023-08-25 16:19:06,NemesisNemesi75,"En Essonne, Christopher 27 ans, a été condamné à six mois de prison seulement avec sursis pour avoir  agressé sexuellement une femme de 56 ans dans la rue en lui claquant les fesses puis en essayant de l’embrasser de force. 

La quinquagénaire ne s’est pas laissée faire et l’a…",95,339,16,450
633,1695051653982929081,2023-08-25 12:33:01,NemesisNemesi75,"Un homme d’une vingtaine d’années a été arrêté ce vendredi matin dans le quartier des Batignolles (Paris XVIIe).

Il est soupçonné d’avoir violée une femme dans la nuit de mercredi à jeudi dans les parties communes d’un immeuble après l’avoir étranglée. 

Il a été placé en garde…",483,900,31,1414
634,1695011535817441315,2023-08-25 09:53:36,NemesisNemesi75,"Notre présidente @CordierAlice2 raconte les agressions qu’elle a vécues à #orleans. Même sa petite sœur en fera les frais. 

➡️La vidéo en entier est a voir sur notre chaîne Youtube :

https://youtu.be/Ct1YQN2s7Qs?si=mWw3jSttCp9n2kPA https://twitter.com/NemesisNemesi75/status/1695011535817441315/video/1",342,741,13,1096
635,1694988357267337476,2023-08-25 08:21:30,NemesisNemesi75,"À Munich, Tony B. un jeune allemand , surprend Aissam D., un marocain, entrain de mettre de la drogue dans le verre d’une jeune femme en discothèque. 

Il le confronte. Aissam D., lui enfoncera des tessons de bouteilles dans les yeux. 
Il est aujourd’hui aveugle de l’oeil gauche… https://twitter.com/NemesisNemesi75/status/1694988357267337476/photo/1",2273,3738,285,6296
636,1694975693698765160,2023-08-25 07:31:11,NemesisNemesi75,@apokrif1 @DamienRieu C’est en effet ce qu’il faudrait faire systématiquement.,0,11,0,11
637,1694973484470882595,2023-08-25 07:22:24,NemesisNemesi75,"@DamienRieu Même stratagème pour le bidouillage des chiffres de la délinquance: il suffit que le pouvoir demande de lever le pied sur l'enregistrement des plaintes pour que les chiffres de la délinquance enregistrée baisse mécaniquement.

C’est ce que faisait déjà Claude Guéant en 2011 dans…",85,296,3,384
638,1694965727915016572,2023-08-25 06:51:35,NemesisNemesi75,"À Strasbourg, un homme de 24 ans a été écroué et mis en examen pour viol, tentative de viol, violation de domicile et agression sexuelle sur 3 femmes dans la même matinée.

Il est soupçonné d'avoir violé une jeune femme devant les Halles. 

Une autre femme a reconnu cet homme qui…",689,1255,80,2024
639,1694959029397680596,2023-08-25 06:24:58,NemesisNemesi75,"Les proches de Mégane, la victime d’Oumar Ndiaye, violée avec barbarie à Cherbourg le 4 août dernier ont lancé une cagnotte Leetchi.

Cette aide financière l’aidera dans sa reconstruction ainsi que pour les frais éventuels à venir (hospitalisation, psychologue, avocats etc.).…",935,1892,60,2887
640,1694744895552909525,2023-08-24 16:14:04,NemesisNemesi75,"La jeune femme de 27 ans lardée de coups de couteau à Montpellier est morte des suites de ses blessures .

La victime aurait reçu une dizaine de coups de couteau après avoir eu un différend dans une voiture avec un jeune de 16 ans, près du quartier de la Mosson. L’adolescent a…",1177,2138,139,3454
641,1694733821243969888,2023-08-24 15:30:04,NemesisNemesi75,"À Paris, Hamedi D., un migrant malien de 42 ans qui avait déjà volé une prostituée brésilienne, à nouveau condamné pour « agression sexuelle » sur une prostituée chinoise cette fois-ci.
Il l’a pourtant viol sous la menace d’un couteau mais les faits ont été requalifiés en simple…",640,1316,89,2045
642,1694650425524232673,2023-08-24 09:58:41,NemesisNemesi75,"Notre présidente @CordierAlice2 nous raconte les différentes agressions qu’elle a vécues à #Orleans. Son propre père et sa petite sœur en ont aussi fait les frais.

➡️Témoignage à visionner en intégralité ici : https://youtu.be/Ct1YQN2s7Qs?si=pFWDMJILVaQM1z2p https://twitter.com/NemesisNemesi75/status/1694650425524232673/video/1",860,1719,116,2695
643,1694597611729154324,2023-08-24 06:28:49,NemesisNemesi75,"Le tribunal correctionnel de Béziers a condamné, mardi 22 août un homme de 39 ans à quatre ans d’emprisonnement, dont un an avec sursis, pour violences conjugales. 

Le 6 juillet dernier, l'homme, pris d'une crise de jalousie, a saccagé une grande partie du mobilier du domicile…",66,217,11,294
644,1694409292508512350,2023-08-23 18:00:30,NemesisNemesi75,"@YehyaBELHAMRA @statsuisse Non justement, ici il n’est pas question de clandestins mais bien de résidents permanents (donc des étrangers qui ont obtenu une carte de résident sous certaines conditions), ils sont là légalement.",4,50,2,56
645,1694408071060054479,2023-08-23 17:55:39,NemesisNemesi75,"@Karim_de_Paris @statsuisse Votre lien parle de la diaspora algérienne qui comme indique l’article ""regroupe la population d’ORIGINE ou de nationalité algérienne vivant à l'extérieur du pays"". Dans le rapport de l’office fédéral Suisse il n’est question que de purs ressortissants algériens (pas tous ceux…",2,11,1,14
646,1694404248543404323,2023-08-23 17:40:28,NemesisNemesi75,@Karim_de_Paris @statsuisse https://twitter.com/NemesisNemesi75/status/1694404248543404323/photo/1,6,34,2,42
647,1694400806370287913,2023-08-23 17:26:47,NemesisNemesi75,"Selon les chiffres fournis par l'Office fédéral de la statistique Suisse @statsuisse🇨🇭 de 2021, les Algériens sont en tête du classement des détenus étrangers les plus représentés avec 287 incarcérations pour 3897 résidents algériens dans le pays

➡️ Soit quasiment 1 Algérien sur…",372,832,25,1229
648,1694398185706340556,2023-08-23 17:16:22,NemesisNemesi75,"L’été de l’enfer continue: une adolescente violée en pleine rue hier à Paris dans le 15eme arrondissement.

Un homme l’aurait forcée à pratiquer une fellation sous la menace d’un cutter.

Le suspect a été interpellé par les agents du GPSR et remis aux policiers arrivés sur place.…",942,1761,103,2806
649,1694334799391887758,2023-08-23 13:04:30,NemesisNemesi75,"@JJJactance La perpétuité réelle incompressible existe en France mais c’est une peine qui est très (trop?) rarement prononcée. 

Il n'y a qu'une poignée de condamnés à la perpétuité réelle : Salah Abdeslam, Pierre Bodein, Michel Fourniret, Nicolas Blondiau et Yannick Luende Bothelo.",4,24,2,30
650,1694285006896578709,2023-08-23 09:46:38,NemesisNemesi75,"Une nouvelle fois une Française a été la proie d’un récidiviste. Perpétuité réelle pour Oumar Ndiaye. 

#cherbourg #violencessexuelles #violencesfaitesauxfemmes https://twitter.com/NemesisNemesi75/status/1694285006896578709/photo/1",889,1948,81,2918
651,1694232280066097208,2023-08-23 06:17:07,NemesisNemesi75,"Salon-de-Provence : un clandestin condamné à 18 mois de prison ferme pour exhibition et agression sexuelles sur deux femmes. 
Il a aussi écopé d'une interdiction de dix ans du territoire français. 

➡️Évidemment, rien ne nous dit que cette interdiction du territoire français sera…",306,690,34,1030
652,1694230397276598459,2023-08-23 06:09:38,NemesisNemesi75,"Encore une énième preuve s’il en fallait du laxisme judiciaire français: 

À Châteauroux, un homme est condamné en juin 2022 à 30 mois de prison pour avoir agressé sexuellement l’une de ses voisines âgée de 78 ans. L'agresseur a aussi porté des coups à l'octogénaire qui criait…",766,1676,82,2524
653,1694225090727104513,2023-08-23 05:48:33,NemesisNemesi75,"Samedi, sur la plage du Porge, deux jeunes filles de 15 et 19 ans nageaient dans la zone de baignade surveillée quand elles ont été agressées sexuellement par un individu. 

Le quadragénaire a profité des vagues pour frotter son sexe sur les vacancières, leur toucher la poitrine…",405,793,38,1236
654,1694065652221280617,2023-08-22 19:15:00,NemesisNemesi75,"Strasbourg, secteur des Halles : Dimanche dernier, une jeune femme, qui rejoignait son véhicule au petit matin, a été suivie et violée par un homme. L’agresseur, qui a été chassé par des témoins, est toujours recherché. 

https://actu.fr/grand-est/strasbourg_67482/une-jeune-femme-violee-en-plein-centre-ville-de-strasbourg-l-agresseur-toujours-en-fuite_59990285.html",161,252,6,419
655,1693998248342774199,2023-08-22 14:47:10,NemesisNemesi75,"Oumar a 18 ans aujourd’hui et quoiqu’il arrive, il ressortira de prison. 

Dans le meilleur des cas notre système judiciaire actuel fait qu’il pourrait ressortir de prison à 45 ans, selon Pierre Marie Séve, le directeur de l'Institut pour la justice. 

Bref autant être claire…",319,1177,106,1602
656,1693990132616192170,2023-08-22 14:14:55,NemesisNemesi75,https://www.lefigaro.fr/faits-divers/il-frappait-sa-mere-le-profil-siderant-d-oumar-n-suspecte-du-viol-barbare-de-cherbourg-20230822,197,368,23,588
657,1693990130116346022,2023-08-22 14:14:54,NemesisNemesi75,"🔴Nouveaux éléments sur Oumar Ndiaye. Depuis son incarcération, les langues se délient dans son quartier :🔴

«Il frappait sa mère. Je l’ai retrouvée plusieurs fois par terre en bas de chez elle, elle me disait : ""c’est Oumar qui m’a shootée'», confie une habitante du quartier où… https://twitter.com/NemesisNemesi75/status/1693990130116346022/photo/1",3159,5192,1106,9457
658,1693882450764562933,2023-08-22 07:07:01,NemesisNemesi75,"@ngoloshabazz Bravo @ngoloshabazz, vous venez vous-même de sous entendre cela tout seul alors que nul part dans notre tweet nous parlons de l’origine des agresseurs 🙃.",13,211,5,229
659,1693881440079851828,2023-08-22 07:03:00,NemesisNemesi75,"Par manque de place dans le local de rétention de la police judiciaire, un migrant en situation irrégulière sur le territoire est laissé libre alors qu’il avait été refusé arrêté pour atteinte sexuelle à Soissons. 

Il avait notamment embrassé sur la bouche une jeune fille de 20…",421,927,63,1411
660,1693684109002834320,2023-08-21 17:58:53,NemesisNemesi75,https://actu.fr/ile-de-france/le-pecq_78481/violences-conjugales-au-pecq-il-apprend-l-adultere-de-sa-femme-et-lui-entaille-les-bras_59982461.html,22,54,0,76
661,1693684107253776840,2023-08-21 17:58:52,NemesisNemesi75,"Rachid N., écope seulement de 4 ans de prison (dont 2 avec sursis) pour avoir frappé puis entaillé les bras de sa compagne avec un tesson de bouteille dans la nuit du 15 au 16 août 2023. Sans l’intervention rapide des pompiers, la victime se serait vidée de son sang.

Malgré ses…",480,1081,71,1632
662,1693567104568504345,2023-08-21 10:13:57,NemesisNemesi75,"@pluspv_ Concernant le refus de dépôt plainte, un rappel un peu long mais bon à savoir:

L’article 15-3, alinéa 1er, du Code de procédure pénale indique que « Les officiers et agents de police judiciaire sont tenus de recevoir les plaintes déposées par les victimes d’infractions à la loi…",51,199,4,254
663,1693562124100894929,2023-08-21 09:54:09,NemesisNemesi75,@KaderMorrocco @LunatiqueFrench Mais on poste aussi quand c’est des français blancs hein…,0,4,0,4
664,1693554564899742102,2023-08-21 09:24:07,NemesisNemesi75,"@KaderMorrocco @LunatiqueFrench Mais encore une fois, rien à voir avec les violences faites aux femmes ici, c’est un braquage …",2,4,1,7
665,1693552780416319896,2023-08-21 09:17:02,NemesisNemesi75,"@KaderMorrocco @LunatiqueFrench On peut avoir la preuve de ce que vous avancez où il faut vous croire sur parole ? Et au cas où vous ne l’aurez pas compris, nous ne répertorions pas toutes les agressions en France, seulement celles qui concernent les femmes.",0,8,1,9
666,1693549318051885304,2023-08-21 09:03:16,NemesisNemesi75,https://www.lejdd.fr/societe/bordeaux-une-jeune-femme-agressee-par-un-algerien-venu-en-france-pour-jouer-au-football-137787,75,141,4,220
667,1693549315514323062,2023-08-21 09:03:16,NemesisNemesi75,"Bordeaux : le 12 août, une femme a été agressée par un Algérien 🇩🇿 arrivé en France en juillet. Il l’a menacée avec un couteau pour obtenir son téléphone. Pourtant, l’agresseur n’a pas de problèmes d’argent. Il explique ne pas savoir les raisons qui l’ont poussé à commettre cette…",914,2014,165,3093
668,1693541565619192080,2023-08-21 08:32:28,NemesisNemesi75,"À Besançon, une femme a été agressée sexuellement vers 2h30 le 18 août alors qu’elle rentrait seule et à pied d’une soirée. 

L’agresseur l’a plaquée au sol en lui touchant ses parties intimes.

Les cris et les appels au secours de la victime ont attiré l’attention de deux…",722,1636,264,2622
669,1693530787214233958,2023-08-21 07:49:38,NemesisNemesi75,"Une jeune fille de 13 ans a été violée deux fois à la piscine municipale de Frot à Meaux, dimanche 13 et jeudi 17 août.

➡️Les auteurs présumés du viol sont deux jeunes garçons âgés de 13 et 14 ans. 

Alors qu’elle se trouvait en compagnie de deux amies, deux jeunes garçons…",834,1580,180,2594
670,1693530554178711697,2023-08-21 07:48:43,NemesisNemesi75,https://www.lefigaro.fr/faits-divers/seine-et-marne-une-adolescente-violee-a-deux-reprises-a-la-piscineii-municipale-de-meaux-20230818,4,2,0,6
671,1692809210864546092,2023-08-19 08:02:21,NemesisNemesi75,"Jeudi 17 août, un homme de 28 a s a été mis en examen pour ""homicide volontaire aggravé"" à Toulouse 10 jours après la mort de sa compagne Jacqueline, 27 ans. 

Il est soupçonné de l'avoir tué de plusieurs coups de couteaux dans l'appartement du couple.

https://france3-regions.francetvinfo.fr/occitanie/haute-garonne/toulouse/feminicide-un-homme-mis-en-examen-sur-son-lit-d-hopital-apres-la-mort-de-sa-compagne-a-coups-de-couteaux-2826491.html",96,161,3,260
672,1692807554139578681,2023-08-19 07:55:46,NemesisNemesi75,"Le jeune Guinéen de 17 ans, auteur d'une intrusion et d'une agression sexuelle sur une mineure de 6 ans à Roanne, en octobre 2022, a été condamné à seulement dix-huit mois de prison ferme, ce jeudi 17 août.

https://www.cnews.fr/france/2023-08-18/agression-sexuelle-dune-fillette-roanne-le-mineur-isole-guineen-condamne-18-mois?amp",518,857,71,1446
673,1692806944619208726,2023-08-19 07:53:21,NemesisNemesi75,"Un animateur de colonies de vacances de 19 ans s, mis en examen pour ""viol sur mineur de 15 ans"" . Il est soupçonné de viol dans la nuit du 13 au 14 août sur une adolescente de 14 ans 

https://www.francebleu.fr/infos/faits-divers-justice/un-animateur-de-colonie-de-vacances-suspecte-de-viol-sur-une-adolescente-nordiste-en-camargue-1781278",252,412,26,690
674,1692639448037515396,2023-08-18 20:47:46,NemesisNemesi75,"Le courage et le bon sens politique de cette femme doit être souligné. « KarimaDelli: Je suis une écologiste et une femme de gauche, viscéralement attachée au respect des gens, à la liberté, l'égalité, la solidarité & la laïcité.

Dès lors, je ne peux soutenir & encore moins cautionner, l’invitation de Médine.
Oui, #MedineFallaitPasLInviter — https://twitter.com/karimadelli/status/1692453106120810729 »",27,194,9,230
675,1692218815281574110,2023-08-17 16:56:20,NemesisNemesi75,"Oui la plupart des viols sont commis dans l’environnement familial et pas en pleine rue. 

Mais quand la victime ne connait pas son agresseur, qu’on le veuille ou non, les hommes issus de l’immigration sont surreprésentés. Les statistiques le disent, les policiers le disent, les…",620,1960,45,2625
676,1692212262906343642,2023-08-17 16:30:17,NemesisNemesi75,"Encore une affaire de viol à Paris : dans la nuit du 16 au 17 août, une jeune femme de 21 ans explique avoir été violée par un serveur dans un bar du 18e arrondissement de la capitale.

L’étudiante explique alors avoir été emmenée de force dans une cuisine par le serveur…",380,887,30,1297
677,1692165461213945998,2023-08-17 13:24:19,NemesisNemesi75,"Il parait que les universités d’été de @EELV , la @FranceInsoumise et la @FetedelHumanite vont recevoir le rappeur #Medine.

C’est bien la peine de nous traiter de « fausses féministes » si c’est pour fricoter avec un ex-ambassadeur de l’association « Havre de savoir » qui défend…",329,953,14,1296
678,1692154019882410193,2023-08-17 12:38:51,NemesisNemesi75,"Très bien @marinetondelier mais que propose votre parti @EELV pour lutter contre les violences sexuelles ?

Comment se traduirait cette fameuse « volonté politique » dont vous parlez puisqu’on sait très bien que vous ne voulez pas plus de fermeté au niveau pénal, policier,… « marinetondelier: Mais quelle horreur. Soutien total à cette jeune femme et à ses proches.

Les violences sexuelles doivent être une réelle priorité nationale, avec une volonté politique et des moyens à la hauteur pr une société qui protège ttes les femmes. Toutes. Partout.
https://www.ouest-france.fr/normandie/cherbourg-en-cotentin-50100/une-instruction-ouverte-pour-viol-avec-actes-de-barbarie-a-cherbourg-6cfd4912-3826-11ee-87b2-9bdf3606b1ab — https://twitter.com/marinetondelier/status/1690325382744981504 »",76,311,10,397
679,1692150080231330074,2023-08-17 12:23:12,NemesisNemesi75,"Le tribunal correctionnel d’Angers a condamné le 14 août 2023 un homme de 32 ans à seulement trois ans de prison (dont dix mois avec sursis) un homme qui a frappé sa compagne à coups de poing, menacé de mort le frère de cette dernière et affirmé vouloir également tuer sa mère, sa…",165,347,14,526
680,1692143347878555812,2023-08-17 11:56:27,NemesisNemesi75,"Toulouse : dans la nuit du mardi 15 au mercredi 16 août 2023 à Colomiers, un homme de 39 ans a tenté d’étrangler son épouse, enceinte de trois mois, devant sa fille de 11 ans. 

Face aux policiers, l’homme s’est rebellé. Il a été placé en cellule de dégrisement et doit être…",23,85,1,109
681,1692099064861425888,2023-08-17 09:00:29,NemesisNemesi75,Source : https://www.lefigaro.fr/faits-divers/a-paris-le-fleau-des-viols-de-rue-ne-faiblit-pas-20220924,6,14,0,20
682,1692099062772711666,2023-08-17 09:00:28,NemesisNemesi75,"Un magistrat parisien chevronné avance deux explications à cette surreprésentation : la misère sexuelle conjuguée à une problématique «culturelle». «Quelqu'un qui n'a pas de domicile ne peut pas violer chez lui, il va faire ça dehors. Il peut aussi y avoir un sujet culturel. Pour…",16,36,5,57
683,1692099060239368697,2023-08-17 09:00:28,NemesisNemesi75,"Cette surreprésentation des étrangers est également visible dans plusieurs affaires de viols de rue récemment survenues dans la capitale. 

Plusieurs policiers nous confirment cette surreprésentation. «Les viols de prédation, dans la rue, sont plutôt le fait de vagabonds,…",10,24,1,35
684,1692099053356552582,2023-08-17 09:00:26,NemesisNemesi75,"Quel est le profil des suspects ? «L'immigration est à prendre en compte mais le sujet est tabou. Il faudrait demander les statistiques sur l'origine des mis en cause», suggère un policier. 

Aucune donnée n'a pu nous être fournie par les autorités à ce sujet. Des chiffres sont…",11,23,1,35
685,1692098841233834254,2023-08-17 08:59:36,NemesisNemesi75,"Selon les chiffres de la préfecture de police de Paris fournis au Figaro, il y a eu 110 viols commis sur la voie publique dans la capitale en 2021 (89 sur des majeurs et 21 sur des mineurs), soit environ neuf par mois. Sur les huit premiers mois de 2022, 66 viols ont été…",13,21,1,35
686,1692098105028579820,2023-08-17 08:56:40,NemesisNemesi75,"[THREAD] À Paris, le fléau des viols de rue ne faiblit pas. Dans la majorité des cas, les agresseurs agissent la nuit sur des femmes qui rentrent seules. 

Aucune donnée n'a pu être fournie par les autorités au sujet de l'origine des mis en cause mais d'après les policiers, les… https://twitter.com/NemesisNemesi75/status/1692098105028579820/photo/1",115,239,12,366
687,1692090863202033883,2023-08-17 08:27:53,NemesisNemesi75,"Paris : une ressortissante autrichienne violée en pleine rue à sa sortie d’un bar dans le 10eme arrondissement de Paris dans la nuit du lundi 14 au mardi 15 août. Le suspect s’est enfui en Velib.

https://www.lefigaro.fr/faits-divers/paris-une-femme-violee-en-pleine-rue-a-sa-sortie-d-un-bar-20230816",138,236,16,390
688,1692078140145725862,2023-08-17 07:37:20,NemesisNemesi75,"Baléares : Cinq Français et un Suisse placés en détention pour agression sexuelle en réunion. Une jeune femme britannique les accuse.

Les faits ont eu lieu « lundi à l’aube dans un hôtel de Magaluf, les personnes arrêtées sont déjà en prison sur ordre du juge », a déclaré à…",110,401,33,544
689,1692076605844165069,2023-08-17 07:31:14,NemesisNemesi75,"Il y a quelques jours, nous avions posté à propos de ce viol d’une femme parisienne dans le 11eme arrondissement de Paris.

Le suspect a été interpellé à Argenteuil :
Il s’agit d’un Algérien de 22 ans en situation irrégulière.

Source : @guillaumepoingt « NemesisNemesi75: Dans la nuit du lundi 7 au mardi 8 août à  Paris dans le 11e arrondissement rue de Charonne, une femme habitant au rez-de-chaussée d’un immeuble et qui dormait la fenêtre ouverte a été surprise en plein sommeil par un individu muni d’un couteau. 

Ce dernier lui aurait demandé de… — https://twitter.com/nemesisnemesi75/status/1688948039803711499 »",556,861,49,1466
690,1692074383978700985,2023-08-17 07:22:25,NemesisNemesi75,"Voici la photo d’Oumar Ndiaye. Avant de violer sauvagement une femme normande, Oumar faisait vivre l’enfer à ses voisines: 

« C’était le caïd du quartier, il nous faisait peur. À cause de lui, c’était devenu l’enfer. Quatre familles ont du déménager ». explique une voisine.… https://twitter.com/NemesisNemesi75/status/1692074383978700985/photo/1",4711,8797,1036,14544
691,1691706155842621700,2023-08-16 06:59:12,NemesisNemesi75,"Enquête pour homicide volontaire ouverte après la découverte du corps d’une femme d’une trentaine d’années à Paris. L’autopsie de la femme décédée chez elle conclut à « une mort violente ». 

Le corps de la victime présentait de nombreuses blessures provoquées par des coups.

A…",340,656,9,1005
692,1690811418768015360,2023-08-13 19:43:50,NemesisNemesi75,"« Je suis déçue » explique Gabrielle, une touriste allemande de 62 ans a été victime d’un vol à la tire sur le Champ-de-Mars le 9 août dernier.

«Choquée» de s’être fait voler sans que personne autour d’elle ne lui soit venu en aide et n’ait couru après le voleur, et surtout «…",668,1984,118,2770
693,1690808653874442240,2023-08-13 19:32:51,NemesisNemesi75,"Samedi soir à Saint Nazaire, un homme sans papier se disant mineur de 17 ans, né en Algérie et faisant l’objet d’une notification d’obligation de quitter le territoire français a été interpellé pour avoir agressé sexuellement un groupe de quatre jeunes filles lors d’un festival…",1235,2282,118,3635
694,1690409852336472064,2023-08-12 17:08:09,NemesisNemesi75,"Un Soudanais menace une policière à cheval au festival interceltique de Lorient.

L’homme s’est vu notifier une convocation à comparaître devant le tribunal correctionnel de Lorient, le 16 mai 2024, pour outrage sur personne dépositaire de l’autorité publique, rébellion et menace…",528,1506,197,2231
695,1690405180741734401,2023-08-12 16:49:35,NemesisNemesi75,"On rêve du jour où @sandrousseau osera écrire/prononcer le nom du criminel quand celui-ci est à consonance étrangère…

Votre soutien à cette femme ne vaut rien si vous soutenez dans le même temps une politique migratoire criminelle « sandrousseau: Le viol n’est pas le résultat d’une pulsion sexuelle, n-ieme illustration. C’est un acte de destruction.
Toute ma solidarité et mon soutien à cette femme.

Manche : un jeune homme de 18 ans interpellé pour viol avec actes de barbarie https://www.francetvinfo.fr/faits-divers/manche-un-jeune-homme-de-18-ans-interpelle-pour-viol-avec-actes-de-barbarie_6001670.html — https://twitter.com/sandrousseau/status/1690393648561577984 »",258,969,20,1247
696,1690397681951047680,2023-08-12 16:19:48,NemesisNemesi75,"Le personnel hospitalier est « habitué » à traiter et à voir des choses atroces. 

Pourtant, la victime d’Oumar N. est tellement dans un état grave que l’hôpital a du activer une cellule psychologique :

https://www.francebleu.fr/infos/faits-divers-justice/le-viol-avec-actes-de-barbarie-d-une-cherbourgeoise-emeut-jusqu-aux-larmes-le-personnel-de-l-hopital-6995522",1116,2280,73,3469
697,1690393750822891521,2023-08-12 16:04:10,NemesisNemesi75,@brandonmiaw @Margueritestern C’est pourquoi nous sommes contre le droit du sol.,21,333,5,359
698,1690390450660597764,2023-08-12 15:51:04,NemesisNemesi75,"«La droite dira ""mais avec nous au pouvoir, Stéphane serait resté en prison"". D'accord, mais Oumar aussi serait en prison.»

Non @Margueritestern. Avec « nous » au pouvoir Oumar n’aurait pas pu venir en France et Stéphane serait resté en prison. Et peut-être bien aussi que ce… https://twitter.com/NemesisNemesi75/status/1690390450660597764/photo/1 « Margueritestern: Une jeune femme vient d'être violée du vagin aux poumons par un homme prénommé Oumar. Son corps présente une perforation du colon, de l'intestin grêle, du péritoine, du diaphragme, du pneumothorax, et des fractures aux côtes. Elle est entre la vie et la mort.

C'est un viol avec… https://twitter.com/Margueritestern/status/1690372469809385472/photo/1 — https://twitter.com/margueritestern/status/1690372469809385472 »",410,1258,36,1704
699,1690322554303422465,2023-08-12 11:21:16,NemesisNemesi75,"Nice: Kamel Hamoud, un jeune homme aux identités multiples, « tantôt Libyen, tantôt Tunisien », a été condamné pour agression sexuelle et vol sur une plage. Il était interdit de séjour dans le département et déjà connu de la justice pour vol. 

https://www.nicematin.com/faits-divers/une-femme-agressee-et-volee-sur-une-plage-de-nice-en-pleine-nuit-un-jeune-condamne-a-six-mois-de-prison-866467",366,518,32,916
700,1690308677373153280,2023-08-12 10:26:07,NemesisNemesi75,"Youssef M., 22 ans, a été interpellé à Cergy. 

Il a exhibé son sexe et obligé sa victime de 71 ans à le caresser, ce qu'elle a fait par peur d'être jetée dans l'Oise.

Une seconde victime a rapporté à la police des propos obscènes. Le suspect a été mis en examen et placé en…",979,2019,159,3157
701,1690011638655766528,2023-08-11 14:45:48,NemesisNemesi75,"⚠️Oumar N., un homme de 18 ans déjà connu des services de police a été interpellé ce jeudi après le viol barbare d’une femme de 29 ans survenu vendredi 4 août à Cherbourg-en-Cotentin.
La victime aurait été violée plusieurs fois notamment avec un manche à balais.⚠️

Les médecins…",2059,3639,566,6264
702,1689578931186233344,2023-08-10 10:06:22,NemesisNemesi75,"Ce mercredi 9 août, Saidou Kane condamné à 21 mois de prison pour des agressions dans le tramway à Caen pour  violences, vol, agression sexuelle et outrage entre le 21 et le 23 juin 2023.

On lui reproche également une tentative d’évasion et d’outrage sexuel envers une policière…",194,466,23,683
703,1689577574492409856,2023-08-10 10:00:59,NemesisNemesi75,"Oise : une joggeuse chute dans le canal du Nord en tentant d’échapper à une agression sexuelle.  Déféré ce lundi 7 août, l’agresseur présumé, un jeune homme de 20 ans, a été placé en détention provisoire. 

https://www.leparisien.fr/amp/oise-60/oise-une-joggeuse-chute-dans-le-canal-du-nord-en-tentant-dechapper-a-une-agression-sexuelle-07-08-2023-OTB6CT7VXRGP5DOVUEPZ54KHYI.php",161,345,8,514
704,1689575616897507328,2023-08-10 09:53:12,NemesisNemesi75,"Une femme âgée de 38 ans a été poignardée à mort à Lyon dans le 3e arrondissement dans les parties communes d'un immeuble situé rue Amiral-Coubert. Le ou les auteurs sont en fuite. 

https://actu17.fr/faits-divers/lyon-une-femme-tuee-a-coups-de-couteau-dans-le-3e-arrondissement.html",361,502,14,877
705,1689285821340188675,2023-08-09 14:41:39,NemesisNemesi75,"Dans l’Oise, un ressortissant du Bangladesh âgé de 31 ans mis en examen pour séquestration et viol d’une adolescente de 15 ans. Les faits se seraient déroulés les 2 et 3 août sur la commune de Margny-lès-Compiègne. 

https://m.20minutes.fr/amp/a/4048542",173,349,20,542
706,1688967325947465741,2023-08-08 17:36:04,NemesisNemesi75,"Malheureusement pour Tariq Ramadan, l’équipe de France de foot féminine s’impose avec un 4-0 face à l’équipe marocaine et accède ainsi aux quarts de finale. 

Bravo à elles !

https://www.francetvinfo.fr/coupe-du-monde/feminine/direct-france-maroc-suivez-le-match-des-huitiemes-de-finale-de-la-coupe-du-monde-feminine-de-football_5994848.html https://twitter.com/NemesisNemesi75/status/1688967325947465741/photo/1",344,2231,91,2666
707,1688948039803711499,2023-08-08 16:19:26,NemesisNemesi75,"Dans la nuit du lundi 7 au mardi 8 août à  Paris dans le 11e arrondissement rue de Charonne, une femme habitant au rez-de-chaussée d’un immeuble et qui dormait la fenêtre ouverte a été surprise en plein sommeil par un individu muni d’un couteau. 

Ce dernier lui aurait demandé de…",297,603,31,931
708,1688807227019141120,2023-08-08 06:59:54,NemesisNemesi75,"Une Allemande âgée de 53 ans a été retrouvée, dans la matinée lundi, par des policiers français à son domicile après avoir alerté la police allemande par téléphone. Elle accuse son mari de séquestration, tortures et viol.

Contrairement à des informations parues plus tôt dans…",35,219,7,261
709,1688170897641811968,2023-08-06 12:51:21,NemesisNemesi75,@BrochardClment1 @leJDD Ça ne change rien à la lettre des familles de victimes.,1,40,2,43
710,1688162646489489408,2023-08-06 12:18:34,NemesisNemesi75,"Pour sa première parution depuis des semaines, le journal @leJDD fait très fort en donnant la parole aux familles de victimes. Une initiative à soutenir. 

Ces familles de victimes disent ne plus vouloir être traités comme de simples faits divers et expliquent dans une lettre… « leJDD: Bon dimanche à tous !
#JAchèteLeJDD https://twitter.com/leJDD/status/1688085533417721856/photo/1 — https://twitter.com/lejdd/status/1688085533417721856 »",481,1551,10,2042
711,1688111750137212928,2023-08-06 08:56:19,NemesisNemesi75,@TariqRamadan L’humiliation est pour vous étant donné que c’est la seule de son équipe qui porte le voile.,36,1159,9,1204
712,1688105729654243328,2023-08-06 08:32:24,NemesisNemesi75,"Sandrine Rousseau parle enfin d’immigration : « sandrousseau: L'extrême-droite est une espèce envahissante, elle s'installe sur le terrain des autres, les conquiert, menace la biodiversité. Elle vient souvent d'un autre continent.
Pour l'empêcher d'avancer, on a besoin de barrières et de plans d'action concertés.
#JDD — https://twitter.com/sandrousseau/status/1688096265895018496 »",118,677,22,817
713,1688102836939206657,2023-08-06 08:20:54,NemesisNemesi75,"La preuve que le voile n’est pas un simple accessoire vestimentaire comme les autres mais bien un outil de propagande : Tariq Ramadan imagine déjà la future « humiliation » que pourrait être une victoire de l’équipe marocaine sur l’équipe française de foot féminin. 

Parler…",683,2179,88,2950
714,1688089086752325632,2023-08-06 07:26:16,NemesisNemesi75,"Le 5 août dernier, Hélène, une femme de 57 ans, a été abattue par son ex-mari Jean-José Lopez (72 ans) sur le parking d’un supermarché.

L’auteur a tué son épouse  et un collègue de travail d'Hélène, qu'il suspectait d'avoir une relation avec elle, puis il s'est suicidé avec…",32,116,2,150
715,1688084067898535937,2023-08-06 07:06:19,NemesisNemesi75,"Samedi 29 juillet à Nandy (Seine-et-Marne): un jeune homme de 17 ans est enlevé en pleine rue. Plus tôt dans la journée, cet homme avait agressé son ancienne petite amie de 16 ans, avec qui il se montrait violent pendant leur relation.

Il continuait aussi de menacer la jeune…",128,533,80,741
716,1688081992758231040,2023-08-06 06:58:04,NemesisNemesi75,"Hélène Carrère d'Encausse, historienne et première femme élue à la tête de l'Académie française, est morte à l'âge de 94 ans. 

Récompensée pour ses travaux académiques, elle a rejoint l'Académie française en 1990, dont elle est devenue la première femme secrétaire perpétuel en… https://twitter.com/NemesisNemesi75/status/1688081992758231040/photo/1",11,113,1,125
717,1688080901886849026,2023-08-06 06:53:44,NemesisNemesi75,"À Nantes, Anas Aarouss, un Marocain 🇲🇦 de 19 ans en ""errance sur le territoire "" depuis son arrivée en France en 2022 vient d’être condamné à 1 an « ferme » seulement pour avoir agressé Lucienne, une femme de 88 ans en lui arrachant son collier.

➡️Il avait déjà été condamné pour…",533,1238,71,1842
718,1687866933339668481,2023-08-05 16:43:30,NemesisNemesi75,"@Ilias_Soledad « La correctionnalisation judiciaire peut se faire par trois biais, qui consistent tous en un mensonge sur la matérialité des faits : tout d’abord en négligeant une circonstance aggravante (ex : vol commis avec l’aide d’une arme blanche requalifié en vol avec violence ;…",4,14,1,19
719,1687866863122817024,2023-08-05 16:43:13,NemesisNemesi75,"@Ilias_Soledad Pas du tout. La requalification d’un viol en agression sexuelle ne nécessite pas forcément un manque de preuves.

Comme ce fut le cas dans cette affaire où le viol était bien caractérisé mais la victime « ne se sentait pas capable d’affronter un long procès » (parfois un délais…",3,20,1,24
720,1687861665294159872,2023-08-05 16:22:34,NemesisNemesi75,@Ilias_Soledad On explique dans le post que le viol a été re qualifié en simple agression sexuelle (c’est ce qui est indiqué dans l’article),1,15,1,17
721,1687859899399892992,2023-08-05 16:15:33,NemesisNemesi75,"@Ilias_Soledad Non justement on ne confond pas lisez notre post, c’est bien le problème",4,66,1,71
722,1687746828668641281,2023-08-05 08:46:15,NemesisNemesi75,https://www.sudouest.fr/justice/agression-sexuelle-apres-la-gay-pride-a-bordeaux-un-an-de-prison-ferme-pour-un-homme-de-20-ans-16174979.php,20,68,0,88
723,1687746827297177600,2023-08-05 08:46:15,NemesisNemesi75,Un Palestinien de 20 ans comparaissait vendredi 4 août devant le tribunal correctionnel pour avoir violé une jeune femme le soir de la Marche des fiertés 2023 à Bordeaux. Celle-ci se trouvait dans un groupe arborant le drapeau arc-en-ciel symbole de la communauté LGBT.…,507,1364,91,1962
724,1687739152278724608,2023-08-05 08:15:45,NemesisNemesi75,https://www.midilibre.fr/2023/08/03/la-justice-a-ignore-hadjira-elle-meurt-poignardee-par-son-mari-trois-mois-apres-le-refus-de-sa-demande-de-protection-11376849.php,18,38,1,57
725,1687739150894592000,2023-08-05 08:15:44,NemesisNemesi75,"Tuée le 21 juillet dernier poignardée par son mari, Hadjira avait vu sa demande d’ordonnance de protection contre son mari, rejetée par le tribunal de Pontoise en mai 2023.

Pour l'avocate d'Hadjira,  ""La justice a ignoré Hadjira, une victime qui avait lancé plusieurs fois des…",198,529,32,759
726,1687736297043963906,2023-08-05 08:04:24,NemesisNemesi75,https://www.valeursactuelles.com/regions/ile-de-france/yvelines/no_agglomeration/faits-divers/yvelines-un-migrant-guineen-na-pas-confiance-en-son-avocate-commise-doffice-et-en-veut-un-autre-de-couleur-noire,14,26,0,40
727,1687736295555035136,2023-08-05 08:04:24,NemesisNemesi75,"Un migrant guinéen de 25 ans inculpé pour le cambriolage d’un pavillon dans les Yvelines exige en garde à vue d’avoir une autre autre avocate qui celle qui lui avait été commise d’office, préférant avoir une avocate « de couleur noire ».",175,466,30,671
728,1687722116823629824,2023-08-05 07:08:03,NemesisNemesi75,https://www.valeursactuelles.com/regions/occitanie/pyrenees-orientales/perpignan/faits-divers/perpignan-un-migrant-clandestin-multirecidiviste-poignarde-une-jeune-femme-sans-raison,24,88,1,113
729,1687722114890039296,2023-08-05 07:08:03,NemesisNemesi75,"Samedi 29 juillet, un Tunisien sous le coup d’une interdiction de territoire français depuis 10 ans et déjà expulsé a poignardé une jeune femme sans raison à Perpignan.

Reconduit en Allemagne il y a quelques années, il a repassé la frontière française.

Déjà quatre fois condamné…",603,1297,65,1965
730,1687721112015159297,2023-08-05 07:04:04,NemesisNemesi75,https://www.ladepeche.fr/2023/08/04/il-percute-mortellement-son-ex-conjointe-en-voiture-ce-que-lon-sait-sur-ce-feminicide-a-prechac-sur-adour-dans-le-gers-11379407.php,7,26,0,33
731,1687721110614220800,2023-08-05 07:04:03,NemesisNemesi75,"Dans la soirée de jeudi à Préchac-sur-Adour, une petite commune de 200 habitants, une femme de 58 ans est morte écrasée par son ex-conjoint (73 ans). Elle était séparée de cet homme et était hébergée chez des amis. 

L'homme était déjà connu des services de gendarmerie : la…",58,180,3,241
732,1687719018944253952,2023-08-05 06:55:45,NemesisNemesi75,"Fêtes de Bayonne : une cinquième plainte pour viol déposée
La plaignante est mineure. Au moment des faits elle était accompagnée d’une autre jeune fille, elle aussi mineure, qui a de son côté porté plainte pour agression sexuelle. 

https://www.leparisien.fr/amp/faits-divers/fetes-de-bayonne-une-cinquieme-plainte-pour-viol-deposee-04-08-2023-RPBYWOF53VCIND3SG6XF4IORSE.php",500,725,32,1257
733,1687714512491704320,2023-08-05 06:37:50,NemesisNemesi75,@Metaway2 ?,0,8,0,8
734,1687480920561922049,2023-08-04 15:09:37,NemesisNemesi75,https://actu.fr/ile-de-france/sartrouville_78586/violences-conjugales-a-sartrouville-il-avait-lui-meme-enregistre-l-agression-de-sa-femme_59927450.html,20,87,5,112
735,1687480918733111296,2023-08-04 15:09:37,NemesisNemesi75,"Moundir, auteur de violences conjugales sur sa femme  à Sartrouville vient d’être condamné à seulement quatre mois de prison avec sursis.

Il avait lui-même enregistré l'agression de sa femme et avait fourni les vidéos à la police car il n’avait pas imaginé que les vidéos en…",352,1035,67,1454
736,1687431818297921536,2023-08-04 11:54:31,NemesisNemesi75,"@KaderMorrocco @CordierAlice2 Mais personne ne nie qu’il y a des pédophiles blancs en prison. Mais si toutes les femmes ne sont pas victimes de viol, elles sont toutes en revanche confrontées au harcèlement de rue.",9,89,2,100
737,1687199221273772033,2023-08-03 20:30:15,NemesisNemesi75,"@fou_allie La capture d’écran que vous donnez ici ne vient pas de l’article que vous avez posté dans votre post initial. Il vient d’ici: https://www.cairn.info/revue-travailler-2012-1-page-157.htm et il concerne une étude sur « une recherche sur les discriminations pénales et civiles selon l’origine, à partir d’un ensemble de…",0,15,1,16
738,1687172362951655427,2023-08-03 18:43:32,NemesisNemesi75,Le rappeur Lomepal (Antoine Valentinelli de son vrai nom) est accusé de viol pour des faits commis à l'étranger. Une plainte a été déposée. https://twitter.com/NemesisNemesi75/status/1687172362951655427/photo/1,42,151,14,207
739,1687148213504024581,2023-08-03 17:07:34,NemesisNemesi75,"@OlivierPailler1 @fou_allie La comparution immédiate n’a rien à voir. Que l’on soit Français ou étranger, on peut être jugé en comparution immédiate si les indices sont jugés suffisants. C’est courant pour les affaires en flagrant délit ou avec beaucoup de témoins. C’est beaucoup moins le cas pour d’autres…",0,2,0,2
740,1687141003113766914,2023-08-03 16:38:55,NemesisNemesi75,"Le PDG de Casino, Jean-Charles Naouri, visé par une information judiciaire pour viol et violences conjugales.

https://www.lemonde.fr/societe/article/2023/08/03/le-pdg-de-casino-jean-charles-naouri-vise-par-une-information-judiciaire-pour-viol-et-violences-conjugales_6184367_3224.html",17,37,4,58
741,1687140628470145026,2023-08-03 16:37:26,NemesisNemesi75,@fou_allie Quel est la source  qui démontrerait que les viols en France (donc des crimes) seraient moins punis quand ils sont le fait de personnes françaises plutôt que de personnes étrangères ? Dans l’article que vous avez mis en lien ce n’est pas du tout ce qui est affirmé.,4,93,3,100
742,1687137457215610891,2023-08-03 16:24:49,NemesisNemesi75,"Encore un petit ange qui a percuté une femme et sa fille de 9 ans en voulant échapper à un contrôle de police à Marseille.

Rassurez-vous : il va bien. Il était positif à l’alcool et aux stupéfiants. Il a été arrêté et placé en garde à vue, où il en a profité pour menacer les…",1612,4612,142,6366
743,1687124573265764352,2023-08-03 15:33:38,NemesisNemesi75,@Ju973720 @CordierAlice2 @mlnyiis Il faut dire qu’ils nous facilitent tellement le travail 🙃: https://twitter.com/NemesisNemesi75/status/1687124573265764352/photo/1,0,41,2,43
744,1687031142904438784,2023-08-03 09:22:22,NemesisNemesi75,"« J’ai changé mes tenues, maintenant, je m’habille comme un sac. On m'a déjà insulté de mécréante,de sale pute, on m'a fait de la drague lourde en me disant que « j’étais fraiche, bonne »... explique Emilie, une Lyonnaise de 23 ans. 

https://actu.fr/auvergne-rhone-alpes/lyon_69123/ces-femmes-subissent-le-harcelement-de-rue-a-lyon-j-ai-toujours-ma-lacrymogene_59919108.html",1326,2334,248,3908
745,1687026899287977984,2023-08-03 09:05:30,NemesisNemesi75,https://twitter.com/NemesisNemesi75/status/1687026899287977984/photo/1 « Medinrecords: « Pour eux le tri sélectif des déchets ça commence aux frontières » — https://twitter.com/medinrecords/status/1686315141435170817 »,5,42,1,48
746,1687007797957853184,2023-08-03 07:49:36,NemesisNemesi75,"@DubreuilBenot1 On ne juge pas de la portée comique mais du ""deux poids deux mesures"" habituel chez les personnes de gauche.",1,25,1,27
747,1687004673696227329,2023-08-03 07:37:11,NemesisNemesi75,"Le « Drag » est aux femmes ce que le «Black face» est aux personnes noires . Mais là bizarrement ça ne vous dérange pas. « thiguane: Collectif Némésis à ça de découvrir que le DRAG existe pour dénoncer le ridicule des stéréotypes de genre 👌🏻

(et que c’est littéralement pour ça que Defontenay a été faite au snatchgame…) — https://twitter.com/thiguane/status/1686989682377097217 »",110,638,14,762
748,1686770099598872576,2023-08-02 16:05:05,NemesisNemesi75,@sandrousseau @DragRace_Fr Ah oui pas du tout formaté DragRace …🙃 https://twitter.com/NemesisNemesi75/status/1686770099598872576/photo/1,104,1928,63,2095
749,1686767955667714049,2023-08-02 15:56:33,NemesisNemesi75,"Elle avait été mise en examen en 2021 pour « transphobie » par l’association Stop Homophobie car elle était opposée à l’ouverture du concours Miss France aux personnes trans. 

Geneviève de Fontenay est décédée à l'âge de 90 ans. 

Elue « Miss Elégance » en 1957, elle fut un… https://twitter.com/NemesisNemesi75/status/1686767955667714049/photo/1",412,2357,116,2885
750,1686299538242330627,2023-08-01 08:55:14,NemesisNemesi75,https://www.lavoixdunord.fr/1358013/article/2023-08-01/viol-en-reunion-au-champ-de-mars-la-tourisme-mexicaine-soupconne-avoir-ete,35,91,3,129
751,1686299536803725312,2023-08-01 08:55:14,NemesisNemesi75,"Viol en réunion au Champ-de-Mars : la touriste mexicaine a porté plainte et soupçonne avoir été droguée . Elle affirme avoir été violée par cinq hommes au Champ-de-Mars, dans la nuit de mercredi à jeudi, après avoir accepté une bière au « goût étrange ».

La jeune femme âgée de…",432,1185,73,1690
752,1685949884791234561,2023-07-31 09:45:50,NemesisNemesi75,"@Johanna_Rolland Découvrir Nantes oui. Mais rien ne dit que nous pouvons le faire en toute sécurité @Johanna_Rolland.

Pour découvrir le vrai visage de Nantes depuis qq années c’est par ici:

« NemesisNemesi75: Il y a quelques jours, nos militantes nantaises ont accroché une banderole sur le célèbre éléphant des Machines de l’ile. Mais ce n’est pas tout ce qu’elles ont fait ! Explications ici ⬇️ https://twitter.com/NemesisNemesi75/status/1682780853762392064/video/1 — https://twitter.com/nemesisnemesi75/status/1682780853762392064 »",31,177,6,214
753,1684891997318844416,2023-07-28 11:42:10,NemesisNemesi75,https://www.bfmtv.com/amp/paris/paris-une-enquete-ouverte-pour-viol-en-reunion-au-champ-de-mars-deux-personnes-interpellees_AN-202307280330.html,33,90,3,126
754,1684891995536330752,2023-07-28 11:42:10,NemesisNemesi75,"Une touriste d'origine mexicaine dit avoir été victime d'un viol en réunion mercredi soir sur le Champ-de-Mars à Paris. Deux personnes ont été interpellées et placées en garde à vue. 

En février dernier, deux touristes brésiliennes ont été vicimes d'une agression sexuelle et…",588,1462,86,2136
755,1684082103988649986,2023-07-26 06:03:56,NemesisNemesi75,https://www.varmatin.com/amp/faits-divers/-les-meufs-comme-toi-elles-tournent-dans-les-caves-une-gendarme-agressee-sur-la-presqu-ile-de-giens-862360,36,111,8,155
756,1684082102466117632,2023-07-26 06:03:56,NemesisNemesi75,"""Je t’enc*le, sale Française, je vais revenir avec une kalach (…) Les meufs comme toi, elles tournent dans les caves »

Ce sont les mots qu’a lancé Badir Y., à Sandrine.

""Moi je suis gendarme, on n’en a rien à foutre de votre kalach"", a alors répliqué la gendarme. 

Au cours…",1796,4256,245,6297
757,1684077173655715840,2023-07-26 05:44:21,NemesisNemesi75,https://www.lefigaro.fr/nice/le-signe-d-un-proselytisme-politique-et-religieux-dans-les-alpes-maritimes-une-deputee-propose-une-loi-contre-le-burkini-20230725,52,174,4,230
758,1684077172066058241,2023-07-26 05:44:21,NemesisNemesi75,"Pendant plus de dix ans, la ville de Mandelieu-la-Napoule dans les Alpes-Maritimes a fait passer un arrêté réglementant la tenue de baignade pendant la période estivale sur son territoire qui interdisait le port du burkini.

Le 17 juillet dernier, le Conseil d’État, la plus haute…",434,1138,68,1640
759,1684074776543875075,2023-07-26 05:34:49,NemesisNemesi75,https://m.20minutes.fr/amp/a/4046822,24,70,3,97
760,1684074774182371328,2023-07-26 05:34:49,NemesisNemesi75,"La loi islamique appliquée en Afghanistan depuis le retour des talibans interdit désormais l’ouverture des salons de beauté du pays.

Privant les femmes d’une de leurs rares sources de revenus et d’un des derniers endroits où elles pouvaient se rencontrer librement, en dehors de… https://twitter.com/NemesisNemesi75/status/1684074774182371328/photo/1",467,1145,67,1679
761,1684068405018517505,2023-07-26 05:09:30,NemesisNemesi75,https://www.ladepeche.fr/2023/07/24/il-tente-dagresser-une-jeune-fille-a-son-domicile-villeneuve-sur-lot-deux-ans-de-prison-11359760.php,87,190,3,280
762,1684068403735035904,2023-07-26 05:09:30,NemesisNemesi75,"À Villeneuve-sur-Lot dans la nuit du samedi 22 au dimanche 23 juillet, un homme de nationalité étrangère tente d’agresser sexuellement une jeune fille de 13 ans dans son sommeil après être rentrée par effraction. La jeune fille se réveille et crie. Sa mère met en fuite…",875,1906,89,2870
763,1683793472824672256,2023-07-25 10:57:01,NemesisNemesi75,https://www.lefigaro.fr/actualite-france/safer-marseille-deploie-sur-ses-plages-un-dispositif-de-securite-pour-proteger-les-femmes-du-harcelement-20230724,8,33,3,44
764,1683793470698258433,2023-07-25 10:57:01,NemesisNemesi75,Marseille déploie sur ses plages un dispositif de sécurité pour protéger les femmes du harcèlement. Le seul dispositif qui serait vraiment efficace pour la tranquillité des femmes sur les plages est celui-ci : https://twitter.com/NemesisNemesi75/status/1683793470698258433/photo/1,638,3169,95,3902
765,1683780846392578048,2023-07-25 10:06:51,NemesisNemesi75,"Mike Razafimahatratra, un jeune étudiant réunionnais d’origine malgache avait assassiné sa petite amie Salma le 9 avril 2020. 

➡️La justice l’a déclaré le mardi 4 juillet 2023 irresponsable pénalement en raison de sa santé mentale. https://twitter.com/NemesisNemesi75/status/1683780846392578048/photo/1",105,215,27,347
766,1683779603888840711,2023-07-25 10:01:55,NemesisNemesi75,https://www.francebleu.fr/infos/faits-divers-justice/une-femme-retrouvee-morte-a-haubourdin-apres-l-arrestation-de-son-compagnon-lors-d-un-controle-de-police-2461435,22,54,2,78
767,1683779602525683718,2023-07-25 10:01:55,NemesisNemesi75,"Lors d’un contrôle de police, un homme alcoolisé a dit aux policiers avoir tué sa compagne. Arrivés sur place à Haubourdin, les policiers ont retrouvé le corps d'une femme. 

D’après le compte @feminicidesfr qui recense les cas de femmes tuées par leur compagnon ou ex-compagnon,…",171,465,9,645
768,1683777603658719232,2023-07-25 09:53:58,NemesisNemesi75,https://actu17.fr/faits-divers/avignon-une-femme-de-56-ans-attaquee-poignardee-et-depouillee-a-son-domicile-un-suspect-interpelle.html,6,20,1,27
769,1683777602027241472,2023-07-25 09:53:58,NemesisNemesi75,"À Avignon, une femme de 56 ans a été poignardée et dépouillée à son domicile. 11 jours d'incapacité totale de travail (ITT) lui ont été attribués. 

L'agresseur présumé, un homme de 30 ans, a été interpellé durant sa fuite et placé en garde à vue.",119,259,6,384
770,1683776670807871488,2023-07-25 09:50:16,NemesisNemesi75,https://m.20minutes.fr/amp/a/4046703,140,372,4,516
771,1683776669423661058,2023-07-25 09:50:15,NemesisNemesi75,"À Strasbourg, une jeune femme de 17 ans a été agressée sexuellement par un sans-abri qui tentait de l’embrasser de force. 

La jeune femme s’est débattue et l’a repoussé avant de trouver de l’aide auprès d’un autre SDF qui est venu à son secours.

L’agresseur, frustré et…",823,2696,72,3591
772,1683773185903284224,2023-07-25 09:36:25,NemesisNemesi75,https://www.leprogres.fr/faits-divers-justice/2023/07/24/je-n-ai-pas-reflechi-je-suis-partie-en-courant-derriere-le-voleur,52,346,9,407
773,1683773182891655168,2023-07-25 09:36:24,NemesisNemesi75,"Clémence Derail, une jeune femme de 25 ans, permet l’interpellation de Saadi, un Algérien en France depuis 2021 qui venait de frapper une dame âgée de 82 ans pour lui arracher ses bijoux en pleine rue à Saint-Etienne. 

Elle a poursuivi l’agresseur puis a réussi à interpeller… https://twitter.com/NemesisNemesi75/status/1683773182891655168/photo/1",1349,4748,204,6301
774,1683769441840926720,2023-07-25 09:21:32,NemesisNemesi75,https://www.20minutes.fr/faits_divers/4037388-20230517-quimper-octogenaire-victime-tentative-viol-pleine-rue,8,20,1,29
775,1683769440377110528,2023-07-25 09:21:32,NemesisNemesi75,"Une octogénaire victime d’une tentative de viol en pleine rue à Quimper. Âgé d’une quarantaine d’années, le suspect a été interpellé et placé en garde à vue. Selon le quotidien, il serait déjà connu pour des faits d’exhibition sexuelle dans le centre-ville de Quimper.",197,351,7,555
776,1683147996601491456,2023-07-23 16:12:08,NemesisNemesi75,@FoxRaikage @le_jarl Mauvaise foi comme d’habitude. Il suffit de regarder la vidéo et nos comptes sur les RS.,0,14,2,16
777,1683147716531195904,2023-07-23 16:11:01,NemesisNemesi75,"Merci beaucoup @le_jarl 🫡 « le_jarl: Je soutiens sans aucune mesure le courage et la détermination du collectif @NemesisNemesi75. Face à l’insécurité grandissante, nous devons tous être des acteurs de leur combat qu’elles portent dignes des grandes guerrières. 
Le Jarl les salue 👊🏻. https://twitter.com/le_jarl/status/1683081266172755970/video/1 — https://twitter.com/le_jarl/status/1683081266172755970 »",69,571,3,643
778,1683040554609790976,2023-07-23 09:05:12,NemesisNemesi75,https://www.bfmtv.com/amp/police-justice/herault-un-homme-condamne-pour-viols-remis-en-liberte-pour-un-vice-de-forme_AV-202307220148.html,19,36,2,57
779,1683040552890281984,2023-07-23 09:05:11,NemesisNemesi75,"Hérault : un homme condamné pour viol et actes pédophiles remis en liberté pour «vice de forme». 

En raison de deux mots manquant sur un acte, l'homme de 71 ans a été remis en liberté dans l'attente d'un nouveau procès. Une situation insupportable pour ses victimes.",378,784,29,1191
780,1683034473749782529,2023-07-23 08:41:02,NemesisNemesi75,https://www.leparisien.fr/faits-divers/grigny-le-corps-dune-femme-decouvert-dans-un-congelateur-22-07-2023-ECI4O4EZOBFGRPCMUZUQI4AC4M.php,38,76,7,121
781,1683034470163546114,2023-07-23 08:41:01,NemesisNemesi75,"Grigny: Une mère de trois enfants âgée d’une quarantaine d’années a été retrouvée morte dans un congélateur samedi matin dans l’appartement de l’homme qu’elle fréquentait depuis un an. 

La victime souhaitait mettre fin  à leur relation, ce qui n’aurait pas plu à son compagnon.…",305,723,56,1084
782,1683030443929608192,2023-07-23 08:25:01,NemesisNemesi75,@DamienRieu Merci @DamienRieu,1,50,1,52
783,1682780853762392064,2023-07-22 15:53:14,NemesisNemesi75,"Il y a quelques jours, nos militantes nantaises ont accroché une banderole sur le célèbre éléphant des Machines de l’ile. Mais ce n’est pas tout ce qu’elles ont fait ! Explications ici ⬇️ https://twitter.com/NemesisNemesi75/status/1682780853762392064/video/1",1233,3071,212,4516
784,1682364364744011776,2023-07-21 12:18:16,NemesisNemesi75,@AimaNuelperlim1 @_a_nissan Elle n’a pas le droit de dire « encore une fois » ? C’est pas de sa faute si c’est pas la première fois.,1,48,3,52
785,1682332521177006080,2023-07-21 10:11:43,NemesisNemesi75,"Petit tour non exhaustif des femmes agressées en France pour une tenue jugée inappropriée:

Une femme agressée à Dijon par deux Afghans pour une tenue jugée ""trop décolletée en période de ramadan "":

https://www.ouest-france.fr/bourgogne-franche-comte/dijon-une-femme-agressee-dans-un-train-pour-une-tenue-trop-decolletee-5788561

Ilias Al Kabbab , un étudiant marocain de 19 ans qui a…",1050,1832,77,2959
786,1682326530679087105,2023-07-21 09:47:55,NemesisNemesi75,"En effet des femmes voilées se font parfois agresser et tuer. Comme Nadia Hassade tuée à Nantes en 2022.  Elle a aussi été victime d’un homme issu de l’immigration : Venkatesh Chanemougame, un indo-pakistanais. 

Personnellement, nous n’avons pas trouvé de cas de femmes voilée…",282,901,20,1203
787,1682298922427899905,2023-07-21 07:58:13,NemesisNemesi75,https://www.lefigaro.fr/faits-divers/une-enquete-preliminaire-ouverte-contre-jean-lassalle-pour-viol-et-agressions-sexuelles-20230721,8,23,2,33
788,1682298920385359872,2023-07-21 07:58:12,NemesisNemesi75,"«Il m'a embrassé deux fois. Je l'ai repoussé. Je lui ai même dit que je pouvais appeler quelqu'un d'autre s'il voulait», confie-t-elle à nos confrères. L’homme politique n’aurait pas écouté son refus. «À ce moment-là, je ne savais plus quoi faire. Je lui ai dit que j'étais… https://twitter.com/NemesisNemesi75/status/1682298920385359872/photo/1",58,184,48,290
789,1682289059954081795,2023-07-21 07:19:01,NemesisNemesi75,"Si les journaux n’ont pas le courage de donner l’origine des agresseurs, la victime elle, l’a : https://twitter.com/NemesisNemesi75/status/1682289059954081795/photo/1",756,1933,45,2734
790,1682285885545500672,2023-07-21 07:06:25,NemesisNemesi75,"Pudiquement, les journaux titrent que ce sont 4 «jeunes» qui sont les agresseurs. Mais au fond de nous-mêmes, nous savons tous que ces «jeunes» sont issus de l’immigration. 

Sous nos yeux, la France est en train de devenir l’Iran. 

https://m.20minutes.fr/amp/a/4046329",856,2063,80,2999
791,1681990444870246400,2023-07-20 11:32:26,NemesisNemesi75,"Yassine El Azizi, le chauffard multirécidiviste qui a tué la gendarme Mélanie Lemée en 2020 vient d’être remis en liberté sous bracelet électronique. Il va donc tranquillement retourner à son domicile d’ici la fin de la semaine. 

En France il faut donc plus de 3 ans pour être… https://twitter.com/NemesisNemesi75/status/1681990444870246400/photo/1",1155,2232,89,3476
792,1681613840851558401,2023-07-19 10:35:57,NemesisNemesi75,"Si vous souhaitez nous aider, vous pouvez nous faire un don sur paypal à l’adresse collectif.nemesis@outlook.fr ou en suivant le lien en bio de notre twitter ! 💙",5,16,0,21
793,1681613834186792960,2023-07-19 10:35:55,NemesisNemesi75,"Cette semaine Oxana notre porte parole Suisse nous parle du harcèlement qu'elle a vécu de la part de son professeur de maths l'année de ses 17 ans. Son école ne la soutiendra pas et tentera même de la faire taire.

Retrouvez son témoignage en intégralité sur notre chaîne Youtube… https://twitter.com/NemesisNemesi75/status/1681613834186792960/video/1",158,389,15,562
794,1681563809020878848,2023-07-19 07:17:08,NemesisNemesi75,https://www.bfmtv.com/politique/front-national/le-rassemblement-national-veut-interdire-certaines-competitions-sportives-aux-transgenres_AD-202307180695.html,15,96,2,113
795,1681563804512006144,2023-07-19 07:17:07,NemesisNemesi75,"Le député RN @JulienOdoul a déposé  une proposition de loi pour ""faire concourir les sportifs dans la catégorie correspondant à leur sexe figurant sur leur acte de naissance"".

""C'est un vrai danger pour le sport féminin, qui vise tout simplement à remplacer des sportives par des…",325,1707,35,2067
796,1681562612532760577,2023-07-19 07:12:23,NemesisNemesi75,Merci @Breizh_Info ! https://www.breizh-info.com/2023/07/19/222666/viols-agressions-vols-le-collectif-feministe-nemesis-mene-une-action-dagit-prop-sur-le-grand-elephant-et-le-voyage-a-nantes/,53,156,2,211
797,1681369584664707072,2023-07-18 18:25:21,NemesisNemesi75,https://www.ladepeche.fr/2023/07/18/nicolas-bedos-vise-par-une-enquete-pour-viol-et-agressions-sexuelles-apres-trois-plaintes-distinctes-11349022.php,4,22,0,26
798,1681369582689189911,2023-07-18 18:25:21,NemesisNemesi75,"Nicolas Bedos visé par une enquête pour viol et agressions sexuelles après trois plaintes distinctes.

Le cinéaste, âgé de 44 ans, doit comparaître en février 2024 devant le tribunal correctionnel de Paris dans une autre procédure pour agression sexuelle en état d'ivresse après… https://twitter.com/NemesisNemesi75/status/1681369582689189911/photo/1",107,306,35,448
799,1681362668299378688,2023-07-18 17:57:52,NemesisNemesi75,"Bien sûr que ça peut arriver partout. Mais étrangement ça arrive à Saint-Denis… 

Vous avez un cursus scientifique pour être archéologue : vous et vos collègues devriez être donc capables d’être un peu plus précis sur la proportion/ fréquence / ethnies majoritaires des… « BMarquebielle: Soutien aux collègues sur le terrain !

Et n’en déplaise aux commentateurs réacs, racistes, misogynes : le harcèlement peut avoir lieu partout, sur le terrain comme au labo, et être le fait de personnes aux profils très variés

Pour plus d’info, jetez un œil  @payetatruelle — https://twitter.com/bmarquebielle/status/1681233351942758400 »",107,599,24,730
800,1681347015777697813,2023-07-18 16:55:41,NemesisNemesi75,La conclusion de @mathildaNemesis est assez piquante 🙃: https://twitter.com/NemesisNemesi75/status/1681347015777697813/video/1,29,117,2,148
801,1681346951202193408,2023-07-18 16:55:25,NemesisNemesi75,Norte porte-parole @mathildaNemesis est intervenue aujourd’hui sur @CNEWS pour parler des femmes archéologues harcelées par des habitants de la ville de Saint-Denis en raison de leurs tenues : https://twitter.com/NemesisNemesi75/status/1681346951202193408/video/1,430,895,34,1359
802,1681321391331635200,2023-07-18 15:13:51,NemesisNemesi75,@HerodoteLeSage @Delphin88004699 Nos militantes n’ont absolument rien dégradé. Vous devriez être plus choqué par les agressions quotidiennes que pour une pauvre banderole qui dénonce ces agressions. Revoyez le sens de vos priorités 🙃,0,14,2,16
803,1681248593636651009,2023-07-18 10:24:35,NemesisNemesi75,"Ce niveau stratosphérique de mauvaise foi démonté en 3 secondes : https://twitter.com/NemesisNemesi75/status/1681248593636651009/photo/1 « ResistanceLesbi: dénoncée dans les discours dominants en France hors de certains milieux militants bizaremment.Les groupes, comme Némésis, auxquels nous nous opposons radicalement, font croire que les hommes blancs ne sont pas un danger pour les femmes. Alors qu'ils violent et violentent tout — https://twitter.com/resistancelesbi/status/1680907992126955521 »",43,191,9,243
804,1681236939922341890,2023-07-18 09:38:17,NemesisNemesi75,"A l’occasion de l’événement estival du Voyage à Nantes, les militantes Nantaises du Collectif Némésis ont décidé de montrer le VRAI voyage à Nantes : Viols, agressions, vols. 

Le «Voyage à Nantes» est matérialisé par une ligne verte tracée au sol qui parcourt les différentes… https://twitter.com/NemesisNemesi75/status/1681236939922341890/video/1",1438,3742,158,5338
805,1681218407134375937,2023-07-18 08:24:38,NemesisNemesi75,@PerJerome @VilleSaintDenis Les deux ! À la fois parce qu’il fait chaud et qu’elles sont habillées court et parce qu’apparemment être archéologue c’est un « métier d’homme».,2,9,2,13
806,1681215843126976513,2023-07-18 08:14:27,NemesisNemesi75,Y aurait-il une culture particulière dans la  @VilleSaintDenis qui expliquerait ce comportement envers des femmes archéologues ? 👀 https://twitter.com/NemesisNemesi75/status/1681215843126976513/video/1,237,696,47,980
807,1681213642161770496,2023-07-18 08:05:42,NemesisNemesi75,https://www.lefigaro.fr/faits-divers/le-violeur-de-tinder-vise-par-de-nouvelles-plaintes-20230717,12,33,1,46
808,1681213636881141761,2023-07-18 08:05:41,NemesisNemesi75,"Salim B. , le violeur de Tinder visé par de nouvelles plaintes.

L’homme, déjà accusé de 17 viols, est de nouveau visé par de nouvelles plaintes:

Ces accusations supplémentaires concernent des faits qui auraient été commis en 2013, 2021, 2022 et 2023. 

Une nouvelle information…",225,383,12,620
809,1681211806096801792,2023-07-18 07:58:24,NemesisNemesi75,https://www.francetvinfo.fr/societe/pornographie/plateforme-porno-french-bukkake-un-proces-requis-contre-17-hommes-pour-violences-sexuelles_5955950.html,9,34,2,45
810,1681211801243992065,2023-07-18 07:58:23,NemesisNemesi75,"Plateforme porno ""French Bukkake"" : un procès requis contre 17 hommes pour violences sexuelles. Le ministère public demande qu'ils soient jugés pour viols, viols en réunion, traite d'êtres humains en bande organisée ou encore pour proxénétisme aggravé.

La majorité des…",150,392,16,558
811,1680961724046868480,2023-07-17 15:24:40,NemesisNemesi75,"@Sammylatortu @xXMarieEuxieXx @Livrenoirmedia @Margueritestern Nous voulons bien un seul post où nous disons que les agresseurs le sont à cause de leur origine ? 

Nous pensons qu’ils le sont à cause de leur culture et de leur éducation : quand on vient d’un pays où l’on voit rarement des femmes en cheveux et en jupe, la frustration sexuelle…",0,8,0,8
812,1680937894540713988,2023-07-17 13:49:59,NemesisNemesi75,@Sammylatortu @xXMarieEuxieXx @Livrenoirmedia @Margueritestern sauf que dans les cas des agressions sexuelles dans les transports dont on parle ici il ne s’agit pas d’un type qui a fait un compliment à une femme,0,2,1,3
813,1680879516690817024,2023-07-17 09:58:00,NemesisNemesi75,"@Livrenoirmedia @Margueritestern Il faut bien comprendre que sur le site du ministère de l’Interieur quand on apprend par exemple que « En Ile-de-France, 
et 63% des agressions sexuelles dans les transports sont le fait d’étrangers » il n’est pas question d’ethnicité (et donc de génétique) mais de simple…",38,212,6,256
814,1680877523092029440,2023-07-17 09:50:05,NemesisNemesi75,"@BrigitteSzczep1 En France, ce ne sont pas des infos qu’on affiche publiquement comme on peut l’avoir dans certains états aux États-unis. Ce n’est pas indiqué sur le front des gens et, en tout cas, là où elle travaillait, personne ne savait qu’il avait déjà tué 20 ans auparavant. 

Rappelons…",3,23,1,27
815,1680873286316457984,2023-07-17 09:33:15,NemesisNemesi75,"@alexafaucher @juliencaret @Margueritestern Non mais il y’en aurait infiniment moins. Vraiment beaucoup moins dans l’espace public. Éviter des milliers d’agressions qui auraient pu l’être de la part d’hommes qui n’auraient pas dû être là, c’est rien pour vous ?",0,3,1,4
816,1680850197973172225,2023-07-17 08:01:30,NemesisNemesi75,@Margueritestern @Livrenoirmedia Changer d’avis est une preuve d’intelligence et d’honnêteté intellectuelle. Et tenir cette position difficile qu’est ce constat de l’impact négatif de l’immigration sur la sécurité et la tranquillité des femmes dans l’espace public est très courageux. Merci pour cet entretien…,10,112,1,123
817,1680849017234702337,2023-07-17 07:56:49,NemesisNemesi75,"Interview à revoir entièrement sur la chaîne de @Livrenoirmedia ici :

https://youtu.be/pVU-TCcHfeM",24,50,1,75
818,1680849013535375361,2023-07-17 07:56:48,NemesisNemesi75,"« Toutes les femmes le savent (…) mais évidemment qu’on se sent en insécurité à Barbes ou dans les quartiers où il y a une surreprésentation d’hommes d’origine africaine ou maghrébine c’est un fait (…)

Et en ce sens-là je soutiens les actions du Collectif Némésis, je les… https://twitter.com/NemesisNemesi75/status/1680849013535375361/video/1",507,1085,18,1610
819,1680842869186129920,2023-07-17 07:32:23,NemesisNemesi75,https://www.laprovence.com/article/faits-divers-justice/73510811902873/marseille-le-jeune-homme-s-etait-frotte-a-une-dame-de-81-ans,31,83,3,117
820,1680842868066340865,2023-07-17 07:32:22,NemesisNemesi75,"Jacqueline, 81 ans, agressée sexuellement par un étranger qui s’est frotté à elle quasiment nu dans la rue à Marseille se défend en lui mettant des coups de balais.

Le prévenu a été condamné à 4 mois de prison seulement et a aussi été frappé d’une interdiction de territoire de…",535,1457,78,2070
821,1680837685068414976,2023-07-17 07:11:47,NemesisNemesi75,https://www.lanouvellerepublique.fr/indre/meurtrier-de-zina-ali-en-2003-dans-l-indre-samy-dioumassy-recidive-et-se-suicide-dans-les-pyrenees-orientales,59,135,0,194
822,1680837683281575938,2023-07-17 07:11:46,NemesisNemesi75,"Il y a tellement de femmes tuées par leur compagnon que parfois nous passons à côté :

Le 14 mai dernier, le corps d’Audrey Felice est retrouvé dans un bois. Elle a été tuée par son ex-compagnon Samy Dioumassy de plusieurs dizaines de coups de cutter.

Samy est aussi retrouvé… https://twitter.com/NemesisNemesi75/status/1680837683281575938/photo/1",1381,3052,174,4607
823,1680693324729012226,2023-07-16 21:38:09,NemesisNemesi75,"Un jeune Kurde de 26 ans, a été condamné à six mois de prison avec sursis pour avoir agressé sexuellement deux jeunes filles sur la plage de Lacanau. 

https://www.sudouest.fr/justice/gironde-il-profitait-des-vagues-pour-agresser-sexuellement-des-baigneuses-15923866.php",121,186,12,319
824,1680465614425542656,2023-07-16 06:33:18,NemesisNemesi75,@AvatarNeuronal L’un ne va pas sans l’autre et le harcèlement découle de ce jugement de valeur. C’est comme l’idéologie antifasciste qui déshumanise des militants de droite et qui conduit à des violences réelles. On ne peut empêcher personne d’avoir des jugements de valeurs mais quand ils sont…,4,84,3,91
825,1680462625467949056,2023-07-16 06:21:26,NemesisNemesi75,"Juste au cas où ça n’aurait pas été bien compris par tous : le fameux « slut shaming », anglicisme pour désigner le harcèlement que subissent des femmes parfois jusqu’à la mort pour leur comportement sexuel réel ou supposé, c’est tout simplement illégal. 

Nous ne voulons plus…",104,480,10,594
826,1679727396365250561,2023-07-14 05:39:53,NemesisNemesi75,"🇫🇷 Les militantes du Collectif Némésis vous souhaitent une très belle fête nationale.

Vive notre armée. 
Vive la France.

Inévitablement, nous avons une pensée pour nos soldats morts au combat.

Puisse le courage des anciens nous donner l’envie de toujours nous battre pour nos… https://twitter.com/NemesisNemesi75/status/1679727396365250561/photo/1",342,1866,28,2236
827,1679516272952844288,2023-07-13 15:40:58,NemesisNemesi75,https://www.francetvinfo.fr/societe/harcelement-sexuel/info-franceinfo-football-l-international-francais-et-attaquant-de-l-as-monaco-wissam-ben-yedder-vise-par-une-enquete-pour-agression-sexuelle-et-viol_5948237.html,7,21,1,29
828,1679516270503362561,2023-07-13 15:40:57,NemesisNemesi75,"L'international français et attaquant de l'AS Monaco Wissam Ben Yedder est visé par une enquête pour viol. La police judiciaire de Nice a été saisie, confirme le parquet.

Deux jeunes femmes de 19 et 20 ans accusent pour l'une Wissam Ben Yedder, pour l'autre son petit frère, de… https://twitter.com/NemesisNemesi75/status/1679516270503362561/photo/1",111,286,17,414
829,1679391252251328512,2023-07-13 07:24:10,NemesisNemesi75,"En Espagne, Francisco Sierra, un député  de gauche de la coalition Sumar au Congrès des députés de Séville, refuse de regarder et d’adresser la parole à son adversaire de droite, Rocío de Meer du parti @vox_es. 

Le comble ? 

Cet homme est professeur de communication 🙃 et se… https://twitter.com/NemesisNemesi75/status/1679391252251328512/video/1",105,368,45,518
830,1678311137081688066,2023-07-10 07:52:11,NemesisNemesi75,https://m.20minutes.fr/amp/a/4044818,23,47,0,70
831,1678311135622176770,2023-07-10 07:52:10,NemesisNemesi75,"Le parquet de Paris demande un procès pour viol aggravé contre l’avocat Alex Ursulet. L’avocat est accusé par une ancienne stagiaire de son cabinet parisien.

Ancien associé de Jacques Vergès et défenseur du tueur en série Guy Georges, Me Ursulet est accusé de viol par une jeune… https://twitter.com/NemesisNemesi75/status/1678311135622176770/photo/1",178,355,10,543
832,1678310228566192128,2023-07-10 07:48:34,NemesisNemesi75,"Tariq Ramadan sera jugé en France par une cour criminelle départementale : il  est suspecté du viol de quatre femmes, entre 2009 et 2014.

La première femme à avoir porté plainte dans cette affaire est Henda Ayari. C'était le 20 octobre 2017. Elle dénonce un viol en 2012. Cette… https://twitter.com/NemesisNemesi75/status/1678310228566192128/photo/1",98,201,6,305
833,1678309195030970369,2023-07-10 07:44:28,NemesisNemesi75,https://www.francetvinfo.fr/societe/harcelement-sexuel/paris-trois-hommes-en-garde-a-vue-soupconnes-de-vol-avec-violences-suivi-d-un-viol-sur-une-etudiante_5940311.html,26,76,1,103
834,1678309193411903488,2023-07-10 07:44:27,NemesisNemesi75,"Trois hommes interpellés par la police : ils sont soupçonnés de vol avec violences suivi d'un viol sur une étudiante samedi dernier vers 23h dans une résidence étudiante dans le 13e arrondissement de Paris.

La jeune fille, présente de multiples contusions. Elle a été transportée…",392,838,28,1258
835,1678307682665615360,2023-07-10 07:38:27,NemesisNemesi75,https://www.leprogres.fr/faits-divers-justice/2023/07/07/dix-ans-de-prison-pour-un-viol-dans-un-foyer-pour-mineurs-isoles,6,33,0,39
836,1678307681327513600,2023-07-10 07:38:27,NemesisNemesi75,"Dix ans de prison pour un viol dans un foyer pour mineurs isolés: 

L’affaire n’était jamais sortie dans la presse et reste même inconnue de certains employés de La Sauvegarde. Le 31 décembre 2019, une salariée de l’ADSEA 01 a été victime d’un viol sous la menace d’une arme.",150,367,3,520
837,1677908127319044096,2023-07-09 05:10:46,NemesisNemesi75,"@T_Bouhafs « NemesisNemesi75: Comme Youssouf Traoré qui a envoyé des messages de menaces à une femme, femme qui, finalement ne portera pas plainte pour ne pas alourdir son casier judiciaire ? https://twitter.com/NemesisNemesi18/status/1337381047479230464/photo/1 — https://twitter.com/nemesisnemesi75/status/1337381047479230464 »",167,464,5,636
838,1677907067447701507,2023-07-09 05:06:33,NemesisNemesi75,"Le militant @T_Bouhafs à l’époque souhaitait empêcher les victimes de Youssouf Traoré de porter plainte, jugeant qu’il ne fallait pas porter plainte contre un « frangin déjà incarcéré » https://twitter.com/NemesisNemesi75/status/1677907067447701507/photo/1",303,923,11,1237
839,1677905070644445186,2023-07-09 04:58:37,NemesisNemesi75,"Youssouf Traoré (le frère d'Assa Traoré) a été interpellé hier pour avoir porté un coup à une commissaire de police sur la place de la République lors de la manifestation interdite et organisée par le comité « La Vérité pour Adama ».

Une dizaine de députés insoumis et… https://twitter.com/NemesisNemesi75/status/1677905070644445186/photo/1",1695,3716,187,5598
840,1677616992830857222,2023-07-08 09:53:54,NemesisNemesi75,https://www.laprovence.com/article/faits-divers-justice/1042181965855216/marseille-une-jeune-femme-violee-au-cours-des-emeutes,43,82,0,125
841,1677616991232720896,2023-07-08 09:53:53,NemesisNemesi75,"⚠️Viol en réunion à Marseille pendant les émeutes :  

La victime aurait été témoin d'exactions lors des émeutes, ""elle était dehors pour voir ce qui se passait"". C’est là qu’elle a été abordée par deux hommes sur la voie publique et conduite, ensuite, dans un lieu privé où le…",386,808,35,1229
842,1677321363885834242,2023-07-07 14:19:10,NemesisNemesi75,https://www.maltatoday.com.mt/news/court_and_police/123789/girl_17_gangraped_by_five_men_and_her_male_friend_beaten_in_eighthour_ordeal_,92,134,4,230
843,1677321360115216385,2023-07-07 14:19:10,NemesisNemesi75,"⚠️Viol collectif d’une Française de 17 ans  à Malte. Un cauchemar qui aurait duré 8 heures d’affilée. Son ami a été tabassé et la scène filmée.⚠️

Cinq «Bruxellois» arrêtés dont un ancien joueur de l’équipe nationale belge de football des moins de 18 ans :

Masuekama Kabangu…",2538,4424,449,7411
844,1677291599821144064,2023-07-07 12:20:54,NemesisNemesi75,https://www.20minutes.fr/faits_divers/4044639-20230707-vendee-homme-grievement-brule-incendie-maison-laquelle-enferme-compagne,16,44,0,60
845,1677291597694640129,2023-07-07 12:20:54,NemesisNemesi75,"En Vendée, un homme est soupçonné de tentative de meurtre sur sa compagne qu’il avait enfermée volontairement dans sa maison avant d’y mettre le feu. La femme a réussi à s’échapper par une baie vitrée. 

Son compagnon aurait alors tenté de la faire revenir dans la maison où il se…",109,272,4,385
846,1677253416043663361,2023-07-07 09:49:10,NemesisNemesi75,"@renardbordelais @CordierAlice2 Pour bien connaître le sujet aussi, les femmes aux États-unis (et évidemment dans les autres pays qui pratiquent la GPA) sont dans l’immense majorité femmes pauvres voir extrêmement pauvres. Étrangement les femmes riches ne se proposent jamais pour être mères porteuses sauf dans…",1,28,1,30
847,1677249255940018176,2023-07-07 09:32:39,NemesisNemesi75,"Pas un seul débordement pour Julie Martin tuée par Hafid Malouk.

Pas un seul débordement pour Melanie Lemee tuée par Yassine El Aziz.

Pas un seul débordement pour Aurelie Châtelain tuée Sid-Ahmed Ghlam

Pas un seul débordement pour Jessica Schneider tuée par Larossi Abballa.…",4340,7921,335,12596
848,1677242114483146752,2023-07-07 09:04:16,NemesisNemesi75,@Juanm234690789 L’avortement n’est pas notre sujet mais sachez quand même pour votre culture personnelle que les départements en France qui avortent le plus sont aussi les départements où il y a le plus d’immigration. Cela devrait vous faire réfléchir aux solutions que vous semblez proposer…,1,8,0,9
849,1677239132223942657,2023-07-07 08:52:25,NemesisNemesi75,"@Juanm234690789 La féminisation de quoi ? Pour rappel :
la politique migratoire française a été quasiment exclusivement mise en place par des hommes, y compris par des hommes de ""droite"" :

De Gaulle : mise en place la libre circulation des Algériens en France de 1962 à 1968

Giscard : mise en…",6,49,3,58
850,1676861805119905792,2023-07-06 07:53:03,NemesisNemesi75,"En somme : la France est capable de trouver des logements à des faux mineurs de 40 ans mais pas à des femmes en danger de mort ! « NemesisNemesi75: ⚠️Pendant que l’État ouvre toujours plus ses portes aux milliers de migrants en France, elle met dans le même temps des femmes victimes de violences conjugales, dont certaines avec des enfants à la rue :⚠️

Depuis 3 semaines, 33 femmes victimes de violences conjugales, certaines… https://twitter.com/NemesisNemesi75/status/1676861567906770944/photo/1 — https://twitter.com/nemesisnemesi75/status/1676861567906770944 »",224,392,1,617
851,1676861570201133056,2023-07-06 07:52:07,NemesisNemesi75,https://www.ladepeche.fr/2023/07/04/toulouse-des-femmes-victimes-de-violences-conjugales-condamnees-a-la-rue-11320316.php,4,16,0,20
852,1676861567906770944,2023-07-06 07:52:07,NemesisNemesi75,"⚠️Pendant que l’État ouvre toujours plus ses portes aux milliers de migrants en France, elle met dans le même temps des femmes victimes de violences conjugales, dont certaines avec des enfants à la rue :⚠️

Depuis 3 semaines, 33 femmes victimes de violences conjugales, certaines… https://twitter.com/NemesisNemesi75/status/1676861567906770944/photo/1",205,403,9,617
853,1676856438667243520,2023-07-06 07:31:44,NemesisNemesi75,https://www.leprogres.fr/faits-divers-justice/2023/07/04/une-femme-blessee-a-l-arme-blanche-entre-la-vie-et-la-mort-a-trevoux,4,18,1,23
854,1676856430115135488,2023-07-06 07:31:42,NemesisNemesi75,"Lundi 3 juillet en fin de journée, une femme de 49 ans a été découverte gravement blessée au niveau de la gorge, avec une arme blanche. 

Son concubin, un homme de 54 ans, était présent sur place et fortement alcoolisé. Il avait été placé en garde à vue. Il faut été libéré mardi…",42,112,5,159
855,1676854365083058177,2023-07-06 07:23:29,NemesisNemesi75,https://france3-regions.francetvinfo.fr/nouvelle-aquitaine/lot-et-garonne/marmande/lot-et-garonne-un-homme-place-en-garde-a-vue-apres-avoir-defenestre-sa-compagne-2807096.html,2,14,0,16
856,1676854363606663168,2023-07-06 07:23:29,NemesisNemesi75,"Un homme, âgé d’une trentaine d’années, est suspecté d'avoir défenestré sa compagne le 2 juillet à Clairac.

Une autre procédure avait été ouverte contre lui le 11 juin dernier pour des violences sur la même concubine et pour laquelle il était en fuite. Il faisait donc l'objet…",47,188,4,239
857,1676851360594120705,2023-07-06 07:11:33,NemesisNemesi75,https://www.europe1.fr/societe/suspension-du-patron-de-la-securite-civile-soupconne-dagression-sexuelle-4192565.amp,2,13,0,15
858,1676851357817421826,2023-07-06 07:11:32,NemesisNemesi75,"Alain Thirion, le patron de la sécurité civile à été suspendu à titre conservatoire de ses fonctions en raison de soupçons d'agression sexuelle.

Les faits se sont déroulés la semaine dernière à l'École supérieure des sapeurs pompiers d'Aix-en-Provence.

En 2019, il avait déjà… https://twitter.com/NemesisNemesi75/status/1676851357817421826/photo/1",43,81,2,126
859,1676849663083794434,2023-07-06 07:04:48,NemesisNemesi75,https://www.europe1.fr/societe/suspension-du-patron-de-la-securite-civile-eesoupconne-dagression-sexuelle-4192565.amp,0,5,1,6
860,1676849660734976000,2023-07-06 07:04:48,NemesisNemesi75,"Alain Thirion, le patron de la sécurité civile a été suspendu lundi ""à titre conservatoire"" de ses fonctions en raison de soupçons d'agression sexuelle. Les faits se sont déroulés la semaine dernière à l'École supérieure des sapeurs pompiers d'Aix-en-Provence.

Alain Thirion… https://twitter.com/NemesisNemesi75/status/1676849660734976000/photo/1",17,75,2,94
861,1676664494011871232,2023-07-05 18:49:00,NemesisNemesi75,"⚠️Viol d’une jeune fille de 12 ans à Nantes sous un pont : un Afghan de 29 ans mis en examen. 

https://www.ouest-france.fr/societe/faits-divers/a-nantes-une-jeune-fille-de-12-ans-violee-sous-un-pont-un-homme-ecroue-74d7122e-1b13-11ee-8c1d-2fa30ad00bee",608,871,80,1559
862,1676556367379791872,2023-07-05 11:39:21,NemesisNemesi75,"@crypt0yabun @kamilabderrahmn @DamienRieu Ça existe pas les ""tournantes consenties"" cretin. Les tournantes c’est des viols collectif et tu le sais très bien. Mais c’est pas grave continue. https://twitter.com/NemesisNemesi75/status/1676556367379791872/photo/1",4,44,1,49
863,1676554099091750913,2023-07-05 11:30:20,NemesisNemesi75,"« J’espère que sa fille va se faire exterminer dans des caves bien sombres après les cours» 

Voilà ce que souhaite @crypt0yabun à @DamienRieu.

#Pharos @gouvernementFR 

On signale ici : 

http://internet-signalement.gouv.fr https://twitter.com/NemesisNemesi75/status/1676554099091750913/photo/1",185,464,22,671
864,1676475191575080960,2023-07-05 06:16:47,NemesisNemesi75,"Le meurtrier présumé de Barbara Blanc, frappée à mort le 7 avril dernier à Saint-Etienne, serait un Algérien en situation irrégulière en France depuis 8 ans.

https://www.leprogres.fr/faits-divers-justice/2023/06/26/meurtre-de-barbara-blanc-un-homme-de-33-ans-mis-en-examen-et-incarcere",432,569,35,1036
865,1676473363852566530,2023-07-05 06:09:31,NemesisNemesi75,"Contrairement à la promesse qu’avait faite @GDarmanin, le policier qui avait traité de « grosse p*te »une femme venue porter plainte pour agression sexuelle en juillet 2022 est toujours en poste. Il avait pourtant promis sa radiation.

https://www.cnews.fr/france/2023-07-03/grosse-pute-le-policier-qui-avait-insulte-une-plaignante-pour-agression-sexuelle?amp",18,58,3,79
866,1676470769654571008,2023-07-05 05:59:13,NemesisNemesi75,"Damien Bailly condamné à 8 ans de prison pour le viol d’une femme de 93 ans à Tournus en octobre 2021.

https://www.lejsl.com/faits-divers-justice/2023/07/04/huit-ans-de-prison-pour-le-viol-d-une-femme-de-93-ans",18,49,5,72
867,1676179533362241536,2023-07-04 10:41:57,NemesisNemesi75,Le chauffard en question s’appelait Yassine El Aziz. Il roulait sans permis sous l’emprise de cocaïne et de cannabis.,6,55,2,63
868,1676177455814524929,2023-07-04 10:33:41,NemesisNemesi75,Erratum : Samedi 8 juillet ;),2,3,1,6
869,1676174214624149504,2023-07-04 10:20:49,NemesisNemesi75,"Il y a trois ans jour pour jour, Mélanie Lemée était tuée dans l’exercice de ses fonctions par un chauffard qui refusait d'obtempérer… 💔 https://twitter.com/NemesisNemesi75/status/1676174214624149504/photo/1",166,432,10,608
870,1676161400064843777,2023-07-04 09:29:54,NemesisNemesi75,"➡️Le Collectif Némésis sera présent à la Fête des moissons avec @MarionMarechal et @stanislasrig ce dimanche 8 juillet près de Lyon. 

Nous y tiendrons un stand, nous espérons vous y voir nombreux !

Infos et inscriptions ici :

https://my.weezevent.com/fete-des-moissons-avec-marion-marechal-et-stanislas-rigault-69

@Reconquete_off…",57,111,4,172
871,1676157502788976640,2023-07-04 09:14:24,NemesisNemesi75,"Encore une preuve criante du laxisme judiciaire : en France, on laisse avoir des permissions de sortie des individus qui purgent des peines pour des crimes et qui sont soupçonnés de plusieurs meurtres ou tentatives de meurtre, dont sur des femmes enceintes. Tout va bien. « NemesisNemesi75: ⚠️⚠️⚠️Stephane L. ,un dangereux détenu qui purgeait deux peines de prison (douze ans pour tentative de meurtre par conjoint et une de trois ans pour des atteintes aux biens aggravées) a profité d'une permission de sortie pour prendre la fuite.⚠️⚠️⚠️

Il est activement recherché… https://twitter.com/NemesisNemesi75/status/1676156121881497601/photo/1 — https://twitter.com/nemesisnemesi75/status/1676156121881497601 »",82,159,1,242
872,1676156121881497601,2023-07-04 09:08:55,NemesisNemesi75,"⚠️⚠️⚠️Stephane L. ,un dangereux détenu qui purgeait deux peines de prison (douze ans pour tentative de meurtre par conjoint et une de trois ans pour des atteintes aux biens aggravées) a profité d'une permission de sortie pour prendre la fuite.⚠️⚠️⚠️

Il est activement recherché… https://twitter.com/NemesisNemesi75/status/1676156121881497601/photo/1",58,86,5,149
873,1676152854828990465,2023-07-04 08:55:56,NemesisNemesi75,"Viol en réunion d'une jeune femme près du Carré Curial à Chambéry : deux hommes mis en examen . Elle a été secourue par le responsable de la sécurité d’une boîte de nuit.

https://www.ledauphine.com/faits-divers-justice/2023/07/03/viol-en-reunion-d-une-jeune-femme-pres-du-carre-curial-deux-hommes-mis-en-examen",59,95,1,155
874,1676152160055173121,2023-07-04 08:53:11,NemesisNemesi75,"Enquête ouverte pour viol contre Jaoued Daouki, connu sous le pseudo « TheKairi78 ».

Une femme l’accuse de l’avoir droguée à son insu avant de la violer à son domicile. 

Les faits remontent à la nuit de samedi à dimanche. Jaoued Daouki, nie avoir drogué la jeune femme, mais… https://twitter.com/NemesisNemesi75/status/1676152160055173121/photo/1",86,303,20,409
875,1675894831187480582,2023-07-03 15:50:39,NemesisNemesi75,"Une moniale agressée sexuellement par un guinéen interdit de territoire depuis 2021. La religieuse faisait partie de l’abbaye de Sainte-Cécile de Solesmes. Mamadou Diakhabi l’aurait plaqué, tenu le buste, touché les seins et léché le visage. https://twitter.com/NemesisNemesi75/status/1675894831187480582/photo/1",239,291,15,545
876,1675790799038980096,2023-07-03 08:57:15,NemesisNemesi75,"@SamirEl47027289 Pourtant nous avons toujours été factuelles avant tout : nous parlons des violences faites aux femmes en France peu importe l’origine des victimes et ou de l’agresseur.

Et nous avons toujours aussi mis un point d’honneur à rendre hommage aux hommes qui prennent des risques pour…",51,635,6,692
877,1675781999657721856,2023-07-03 08:22:17,NemesisNemesi75,https://france3-regions.francetvinfo.fr/auvergne-rhone-alpes/rhone/lyon/temoignage-il-faut-que-ces-emeutes-s-arretent-un-homme-entre-la-vie-et-la-mort-depuis-l-incendie-de-villeurbanne-2806304.html,38,78,1,117
878,1675781997774422017,2023-07-03 08:22:17,NemesisNemesi75,"Farès, un père de famille de 29 ans, n'a pas hésité à sauver la vie d'une femme, dans la nuit du 28 au 29 juin dernier, alors qu'un incendie avait été provoqué par un engin incendiaire dans son immeuble de Villeurbanne. 

Ce samedi 1ᵉʳ juillet, le jeune père de famille est… https://twitter.com/NemesisNemesi75/status/1675781997774422017/photo/1",1187,4134,152,5473
879,1675768102821273600,2023-07-03 07:27:04,NemesisNemesi75,"Selim Fourniret, fils unique du tueur en série et de sa complice Monique Olivier, aurait profité d'une porte ouverte pour rentrer dans une copropriété. 

Il serait alors tombé nez à nez avec une jeune fille, avant de lui mettre la main sur la bouche, de commettre des… https://twitter.com/NemesisNemesi75/status/1675768102821273600/photo/1",174,348,50,572
880,1675463786692476929,2023-07-02 11:17:50,NemesisNemesi75,"Une dame de 70 ans demande à un homme de lui céder sa place dans le tramway à Nice. L’homme refuse, la femme lui reproche son comportement incivique, il la frappe au visage.

https://www.nicematin.com/faits-divers/une-septuagenaire-frappee-au-visage-dans-le-tramway-a-nice-par-un-passager-qui-refusait-de-ceder-sa-place-858468",167,157,8,332
881,1675461490143289344,2023-07-02 11:08:42,NemesisNemesi75,"""On sait où vous habitez, on va vous brûler vivant.""

Avait déjà rapporté @VincentJeanbrun quelques jours avant l’attaque ignoble de cette nuit où une voiture-bélier ""enflammée"" a été lancée sur la maison de ce maire de L'Haÿ-les-Roses cette nuit alors que sa femme et ses deux… https://twitter.com/NemesisNemesi75/status/1675461490143289344/photo/1",135,248,5,388
882,1675421056926973952,2023-07-02 08:28:02,NemesisNemesi75,"Voilà comment te considère l’un de tes petits protégés « racisés »@mariecchambel. 

Si toi tu les considères comme tes alliés, sache qu’il n’en sera jamais de même pour eux. « bahaelfakir: Les femmes blanches ont allègrement participé à l’esclavages et à la colonisations. 

Les violences de ces derniers jours ne sont que conséquences des violences institutionnelles des blancs sur plusieurs siècles.

Vous êtes complice par votre silence, même en tant que femmes. — https://twitter.com/ahabelghani/status/1674745706047840257 »",169,306,12,487
883,1675037295743729664,2023-07-01 07:03:06,NemesisNemesi75,https://actu.fr/auvergne-rhone-alpes/riom_63300/pres-de-clermont-il-gifle-sa-compagne-et-met-le-feu-a-l-appartement_59795726.html,5,21,0,26
884,1675037294313586692,2023-07-01 07:03:06,NemesisNemesi75,"Un « marginal » ressort libre de sa garde à vue après a avoir été interpellé pour des faits de violences conjugales et pour avoir mis le feu à l’appartement de la victime, dimanche 25 juin à Riom, près de Clermont-Ferrand.

L’homme était déjà connu par les services de police pour…",122,327,10,459
885,1675034378810867713,2023-07-01 06:51:31,NemesisNemesi75,https://www.lavoixdunord.fr/1346624/article/2023-06-29/fenain-il-brutalise-son-ex-femme-puis-lui-envoie-1-400-messages-en-trois,3,16,1,20
886,1675034375816134657,2023-07-01 06:51:30,NemesisNemesi75,"6 mois de prison ferme seulement qui seront aménagés par le juge de l’application des peines pour un certain «C.M», un homme qui avait frappé son ex-épouse. 

Au cours de l’été suivant ses violences et en l’espace de trois semaines, il l’a également harcelée et lui a envoyé pas…",38,139,2,179
887,1675032266467168256,2023-07-01 06:43:07,NemesisNemesi75,https://www.nicematin.com/justice/pour-son-premier-verdict-la-cour-criminelle-departementale-condamne-un-sexagenaire-a-12-ans-de-reclusion-pour-viol-sur-mineure-858189,2,14,0,16
888,1675032263652700160,2023-07-01 06:43:06,NemesisNemesi75,"Gilles Parrot, un Niçois de 62 ans vient d’être condamné pour viol et agression sexuelle sur une jeune fille de 11 ans. 

L’accusé avait sympathisé avec une famille exilée. Il a profité de la situation pour s’attirer sa confiance. Il était accusé d’avoir violé à plusieurs…",60,167,10,237
889,1675026464402489344,2023-07-01 06:20:04,NemesisNemesi75,"La photo, de Dominique P., le mari en question : https://twitter.com/NemesisNemesi75/status/1675026464402489344/photo/1",51,139,4,194
890,1675024947293429761,2023-07-01 06:14:02,NemesisNemesi75,https://www.ouest-france.fr/faits-divers/violence-sexuelle/viol/viols-de-mazan-51-hommes-vont-etre-juges-par-la-cour-criminelle-du-vaucluse-en-2024-4288ceb8-165c-11ee-91ca-7ab58a7217eb,23,86,2,111
891,1675024945993195520,2023-07-01 06:14:02,NemesisNemesi75,"51 hommes vont être jugés par la cour criminelle du Vaucluse en 2024 pour les « viols de Mazan ». 

Pour rappel, Dominique P., droguait sa femme et invitait des inconnus à la violer alors qu’elle était totalement inconsciente. 

Il avait déclaré : « Ma femme était raciste, moi…",440,1077,67,1584
892,1675014132490280961,2023-07-01 05:31:04,NemesisNemesi75,"Tout ce qui ne va pas avec le féminisme «intersectionel» en un tweet. 

@mariecchambel n’a pas eu un mot pour les prostituées attaquées par ses petits protégés «racisés». Elle n’a pas eu un mot non plus à l’époque pour Shaina assassinée, violée et agressée par des hommes… « mariecchambel: La lutte contre les violences dirigées vers les femmes ne doit pas nous occulter le fait que les hommes racisés connaissent également des oppressions systémiques, puisque le système policier est un système qui s’attaque en premier lieu aux hommes précaires et racisés. — https://twitter.com/mariecchambel/status/1674813026707423235 »",183,616,23,822
893,1674772681563029505,2023-06-30 13:31:37,NemesisNemesi75,"« Toi ta gueule la vieille on va te cramer ! »

À Villeurbanne cette nuit, une femme a demandé aux émeutiers d’arrêter de faire du bruit parce que son enfant dormait. En réponse, les émeutiers sont revenus tirer en direction de son appartement, provoquant l’incendie de cet… https://twitter.com/NemesisNemesi75/status/1674772681563029505/video/1",669,957,54,1680
894,1674768637352083463,2023-06-30 13:15:33,NemesisNemesi75,"Voici ce qu’il reste du bus de l’association @ACF_WCHF , incendié à @villedebobigny. 

Cette association intervient auprès des femmes les plus précaires pour prévenir les maladies cardiovasculaires. 

Ce bus devait accueillir gratuitement des femmes en septembre… https://twitter.com/NemesisNemesi75/status/1674768637352083463/photo/1",276,497,10,783
895,1674716206006259713,2023-06-30 09:47:12,NemesisNemesi75,@JulietteBriens Plus engagées politiquement que jamais.,0,34,1,35
896,1674693787497398272,2023-06-30 08:18:07,NemesisNemesi75,"« Le Coran Wallah ça allume les tinpes.» 

Des prostituées ont été attaquées au mortier pendant les émeutes. Aucun respect ni pour les biens, ni pour les êtres humains. https://twitter.com/NemesisNemesi75/status/1674693787497398272/video/1",276,665,54,995
897,1674691623819657216,2023-06-30 08:09:32,NemesisNemesi75,« Plus facile de fermer les bars que d’enfermer les barbares » https://twitter.com/NemesisNemesi75/status/1674691623819657216/photo/1,102,340,4,446
898,1674677035959046147,2023-06-30 07:11:34,NemesisNemesi75,"Après ces deux dernières nuits, qu’on ne vienne plus jamais nous parler de récupération, de calme et de dignité. 

Plus jamais.",674,3242,37,3953
899,1674436351750725632,2023-06-29 15:15:10,NemesisNemesi75,"« Bientôt pour ne pas se faire égorger en France, il faudra apprendre des passages du coran et/ou parler arabe » 

Oh mais attendez, ça par contre, ça n’est pas de la fiction, contrairement à vos délires @FeizaBM, ça existe déjà en France : https://twitter.com/NemesisNemesi75/status/1674436351750725632/photo/1 « FeizaBM: Bientôt pour rentrer à l’école il faudra avaler une tranche de jambon devant la grille sinon le portail ne s’ouvrira pas — https://twitter.com/feizabm/status/1674152126082162691 »",152,413,11,576
900,1674414872812044289,2023-06-29 13:49:49,NemesisNemesi75,Le Conseil d’Etat a refusé le hijab dans le foot féminin. Prêtes à fêter ça avec @JeanMessiha 🥂 🍾 et vous ? https://twitter.com/NemesisNemesi75/status/1674414872812044289/video/1,274,1285,58,1617
901,1674324083754909696,2023-06-29 07:49:03,NemesisNemesi75,https://amp.lepoint.fr/2526677,5,17,0,22
902,1674324082127519746,2023-06-29 07:49:03,NemesisNemesi75,"Ce jeudi, le Conseil d'État, la plus haute juridiction administrative, doit rendre sa décision sur l’autorisation ou non du port du hidjab dans le football féminin. 

Nous espérons qu’ils ne céderont pas, par peur ou par lâcheté, aux revendications communautaires de ce collectif…",198,741,31,970
903,1674314099201540100,2023-06-29 07:09:23,NemesisNemesi75,"Assises du Tarn : Yannick Cabos condamné à 15 ans de réclusion criminelle pour des viols sur deux de ses ex-conjointes 

https://www.ladepeche.fr/2023/06/28/assises-du-tarn-yannick-cabos-condamne-a-15-ans-de-reclusion-criminelle-pour-viols-sur-conjoint-11306803.php",7,22,0,29
904,1674312876826271748,2023-06-29 07:04:31,NemesisNemesi75,"À Cenon, un homme de 31 ans sous OQTF a agressé sexuellement une femme et s’est exhibé devant d’autres passagers du tramway avant d’être arrêté. 

https://www.sudouest.fr/gironde/cenon/un-frotteur-et-exhibitionniste-interpelle-dans-le-tramway-pres-de-bordeaux-15716721.php",88,122,6,216
905,1673991292479578115,2023-06-28 09:46:40,NemesisNemesi75,"Voici une liste non-exhaustive de ce qu’il peut se passer en une semaine en France. Mais évidemment, ce ne sont pas ces histoires là dont @LouisBoyard , @sandrousseau , @OmarSy ou encore @KMbappe ont choisi de parler cette semaine : https://twitter.com/NemesisNemesi75/status/1673991292479578115/photo/1",338,628,5,971
906,1673972391217692674,2023-06-28 08:31:33,NemesisNemesi75,"Tous les jours, nous publions des «faits-divers» horribles : des petites filles violées, des femmes massacrées par leur ex-conjoint. Ces histoires ne font parfois pas 3 lignes dans les journaux dans des articles payants. 

Devinez quelle est l’histoire qui en ce moment retient…",903,2925,62,3890
907,1673708134525706241,2023-06-27 15:01:29,NemesisNemesi75,https://la1ere.francetvinfo.fr/mayotte/l-ex-compagnon-de-nadine-seon-disparue-depuis-dimanche-avoue-l-avoir-tue-1409780.html,0,8,0,8
908,1673708132927774721,2023-06-27 15:01:29,NemesisNemesi75,"À Mayotte dimanche dernier, Nadine Seon est morte. Son ex-compagnon a avoué l'avoir étranglé avant d'emballer son corps dans un sac poubelle et de le jeter dans une benne à ordures. Il avait  déjà été condamné pour des faits de violences sur son ex-compagne.",46,115,2,163
909,1673705044150026240,2023-06-27 14:49:13,NemesisNemesi75,https://www.ledauphine.com/faits-divers-justice/2023/06/23/isere-grenoble-un-homme-condamne-pour-viol-et-agression-sexuelle-le-recit-glacant-des-victimes,23,101,3,127
910,1673705042346496001,2023-06-27 14:49:12,NemesisNemesi75,"""J’en n’ai rien à foutre de la police et de la religion” avait dit Mahmoud El Helali à une femme de 80 ans avant de la pousser violemment sur le sol et de la violer sous la le menace d’un couteau.

Il écope de 15 ans de prison. Une peine assortie d’une interdiction définitive du…",406,1010,24,1440
911,1673584495511891968,2023-06-27 06:50:12,NemesisNemesi75,https://www.lefigaro.fr/nantes/saint-nazaire-suspecte-d-agression-sexuelle-sur-des-jeunes-filles-un-mineur-menace-de-mort-des-policiers-20230626,41,97,1,139
912,1673584494132043782,2023-06-27 06:50:11,NemesisNemesi75,"Un Algérien en situation irrégulière sur le territoire français et se disant mineur suspecté d'agression sexuelle sur un groupe de quatre jeunes filles spectatrices d'un festival de musique à Saint Nazaire. 

Des membres de la brigade canine de la police nationale du commissariat…",487,1203,96,1786
913,1673251233245679617,2023-06-26 08:45:56,NemesisNemesi75,https://www.leparisien.fr/faits-divers/il-piegeait-les-femmes-avec-son-velo-touk-touk-un-predateur-sexuel-devant-la-justice-25-06-2023-CUES6GZAXFC47ELXWO7CV5LC6Q.php,23,70,1,94
914,1673251231895093248,2023-06-26 08:45:55,NemesisNemesi75,"Le procès de Shahin S., un Bangladais de 45 ans arrivé clandestinement en France, s’ouvre aujourd’hui.

Il accusé d’avoir violé 4 femmes et d’en avoir agressé 2 autres. 

Son mode opératoire : il embarquait les victimes, dont des touristes coréennes, à bord de son pousse-pousse…",212,505,23,740
915,1673240303313068032,2023-06-26 08:02:30,NemesisNemesi75,@louise29911 @Chaolin30900 Si nous l’avions nous l’aurions donné comme d’habitude,1,88,3,92
916,1673237030396887040,2023-06-26 07:49:29,NemesisNemesi75,https://www.ouest-france.fr/faits-divers/violence-sexuelle/viol/un-homme-juge-pour-le-viol-dune-receptionniste-dhotel-pres-de-rennes-8325bd82-1107-11ee-be68-0182cf49ad63,6,33,3,42
917,1673237028903833602,2023-06-26 07:49:29,NemesisNemesi75,"Un homme jugé pour le viol d’une jeune femme de 19 ans réceptionniste d’hôtel près de Rennes. En octobre 2020, la réceptionniste d’un hôtel de Chantepie a été victime d’un viol, sous la menace d’un couteau, dans la chambre d’un client. 

Ce dernier comparait du mardi 27 au jeudi…",97,289,6,392
918,1673234493803491333,2023-06-26 07:39:25,NemesisNemesi75,https://www.leparisien.fr/amp/faits-divers/soupconne-davoir-viole-une-ado-puis-une-nonagenaire-il-aurait-recidive-sur-son-codetenu-a-fresnes-25-06-2023-HY2AX52JQJEZRN2PIHDKJK25ZQ.php,42,107,5,154
919,1673234492218015745,2023-06-26 07:39:24,NemesisNemesi75,"Déjà en détention pour avoir violé sa voisine de 96 ans et en attente de son procès pour des viols répétés sur une jeune fille de 14 ans, un habitant de Clichy-la-Garenne qui venait d’être incarcéré dans le Val-de-Marne après des incidents à la prison de Nanterre, aurait agressé…",406,848,83,1337
920,1673227416494301187,2023-06-26 07:11:17,NemesisNemesi75,https://actu.fr/auvergne-rhone-alpes/lyon_69123/laicite-l-abaya-cartonne-chez-les-jeunes-filles-les-lycees-de-lyon-depasses_59766543.html,10,29,0,39
921,1673227414850207745,2023-06-26 07:11:17,NemesisNemesi75,"À Lyon aussi les lycées sont dépassés par le phénomène des abayas où nouveau vêtement est toléré dans certains établissements scolaires malgré la loi de 2004 sur la laïcité. 

Devant le lycée Condorcet de Saint-Priest proche de Lyon,une grande proportion de jeunes filles porte…",175,439,36,650
922,1673221381989736453,2023-06-26 06:47:19,NemesisNemesi75,https://www.valeursactuelles.com/clubvaleurs/societe/abaya-la-nouvelle-mode-islamique-qui-defie-la-laicite,34,128,2,164
923,1673221380718972928,2023-06-26 06:47:18,NemesisNemesi75,"« À Bruxelles, l’ampleur est telle que même les filles qui ne sont pas musulmanes sont obligées de porter des vêtements amples qui couvrent les bras et le buste jusqu’au cou. 

Si elles sont considérées ‘trop dénudées’, elles subissent du harcèlement de la part des garçons et…",852,1754,97,2703
924,1673218838484197379,2023-06-26 06:37:12,NemesisNemesi75,https://www.lavoixdunord.fr/1344323/article/2023-06-23/doudeauville-un-important-dispositif-de-secours-dans-le-hameau-de-beaucorroy,1,17,0,18
925,1673218836982579205,2023-06-26 06:37:12,NemesisNemesi75,"« Il veut me tuer, il a une arme ».

C’est ce qu’a dit Martine (60 ans) à sa fille par messages le 23 juin dernier dans le Pas-de-Calais.

 Son ex-compagnon ne supportait pas leur récente rupture, il a donc ouvert le feu sur elle avant de retourner l’arme contre lui.",48,162,3,213
926,1672868335137030144,2023-06-25 07:24:26,NemesisNemesi75,"Pour avoir déployé une simple banderole, des militants de @DefendsMars sont en garde à vue.

Le traitement réservé aux personnes qui protestent contre l’immigration est toujours incroyablement rapide et disproportionné quand on le compare au traitement de centaines de black… « DefendsMars: Les militants de “Défends Marseille” sont en garde-à-vue depuis 5 heures ! 

Ils ont dénoncé l’invasion migratoire et le rôle des ONG pro-migrants comme @SOSMedFrance dans ce processus.

Ils ont besoin de votre soutien ici ⬇⬇

https://stop-sos-mediterranee.com https://twitter.com/DefendsMars/status/1672713086464131072/photo/1 — https://twitter.com/defendsmars/status/1672713086464131072 »",819,1984,65,2868
927,1672294305052934158,2023-06-23 17:23:26,NemesisNemesi75,"🤯Témoignage d’une abonnée concernant Nicolas Bedos. 🤯

Visiblement #NicolasBedos n’en n’est pas à son coup d’essai. Incroyable le nombre de personnalités de gauche bien moralisatrices dans les médias qui en privé se croient tout permis : « CordierAlice2: « Il m’a mordu le cou et est parti »

Témoignage d’une de mes abonnées, habituée des mêmes lieux de soirées que Nicolas Bedos.
Je croyais que les faits qui lui étaient reprochés étaient « accidentels », en fait c’est une habitude chez lui ? 🤔

#NicolasBedos https://twitter.com/CordierAlice2/status/1672234712113225729/photo/1 — https://twitter.com/cordieralice2/status/1672234712113225729 »",57,134,13,204
928,1672159106168233984,2023-06-23 08:26:12,NemesisNemesi75,"Parler du sort des migrants, c’est pas de la récupération ✅

Parler du sort des Français, c’est de la récupération 🚫

Nous espérons @MathildePanot que vous n’avez pas oublié pendant votre discours de préciser que dans ce naufrage il y avait à bord des femmes et des enfants mais… « MathildePanot: Moment de recueillement ce soir en hommage aux plus de 600 hommes, femmes et enfants morts au large de la Grèce.

La Méditerranée est la frontière la plus meurtrière au monde avec des dizaines de milliers de personnes mortes en mer. 

Dans le silence et l’indifférence généralisée… https://twitter.com/MathildePanot/status/1671981016825602072/photo/1 — https://twitter.com/mathildepanot/status/1671981016825602072 »",228,719,7,954
929,1672154490818928640,2023-06-23 08:07:52,NemesisNemesi75,https://www.leparisien.fr/amp/oise-60/qui-est-stephane-l-juge-pour-plusieurs-viols-a-beauvais-et-mis-en-cause-dans-un-vaste-trafic-de-drogue-20-06-2023-3GTDFOLMWVC6FBST6FVEOS77WY.php,8,40,0,48
930,1672154488164040709,2023-06-23 08:07:51,NemesisNemesi75,"Accusé de cinq viols, Stéphane L. se décrit comme un « narcissique » aux « 450 femmes ».

Cet homme de 49 ans comparaît à partir de mercredi à la cour d’assises de l’Oise pour des faits de « viols » et « viols en réunion » qui auraient été commis entre 2001 et 2009.

Certaines… https://twitter.com/NemesisNemesi75/status/1672154488164040709/photo/1",176,460,41,677
931,1672152539653971970,2023-06-23 08:00:07,NemesisNemesi75,"Omar Ouzzig, l’assassin de #Shaina est définitivement condamné à seulement 18 ans de prison. Il n’y aura pas d’appel.

L’avocat général avait pourtant requis 30 ans de prison à l’encontre de l’accusé. 

Pour le frère de Shaïna, la peine n’est pas assez lourde : “C’est… https://twitter.com/NemesisNemesi75/status/1672152539653971970/photo/1",421,1452,103,1976
932,1672149444106518529,2023-06-23 07:47:49,NemesisNemesi75,https://www.midilibre.fr/2023/06/22/un-voleur-de-sac-a-main-blesse-trois-personnes-au-couteau-et-casse-les-dents-dune-quatrieme-a-montpellier-11294513.php,136,237,6,379
933,1672149442785431552,2023-06-23 07:47:48,NemesisNemesi75,"À Montpellier, un Algérien de 17 ans a tenté de voler le sac à main d'une jeune femme de 27 ans qui ne s'est pas laissée faire. 

Sortant un couteau de sa poche, il lui a alors asséné plusieurs coups de lame qu'elle est parvenue à esquiver. Témoin de l'agression, la sœur de la…",1027,1992,188,3207
934,1672146015636291585,2023-06-23 07:34:11,NemesisNemesi75,"Naufrage en Grèce: d’après des témoignages d’hommes survivants, ceux-ci affirment qu’il y avait bien à bord des femmes et des enfants mais aucun n’a été retrouvé parce qu’ils étaient enfermés dans la cale afin d’être “ protégés ” des passagers de sexe masculin.…",369,878,69,1316
935,1672143557707067392,2023-06-23 07:24:25,NemesisNemesi75,https://www.bfmtv.com/amp/normandie/seine-maritime-une-femme-retrouvee-morte-a-grand-couronne-son-compagnon-place-en-garde-a-vue_AV-202306220796.html,1,6,0,7
936,1672143556448866304,2023-06-23 07:24:25,NemesisNemesi75,Une femme âgée de 40 ans est décédée à son domicile à Grand-Couronne (Seine-Maritime) dans des conditions très suspectes. Son corps a été retrouvé dans sa baignoire et présentait des traces de coup. Le mari a été interpellé et placé en garde à vue.,20,74,2,96
937,1672141803582021635,2023-06-23 07:17:27,NemesisNemesi75,https://www.francetvinfo.fr/societe/harcelement-sexuel/le-realisateur-nicolas-bedos-vise-par-une-plainte-pour-agression-sexuelle_5904728.html,1,8,0,9
938,1672141801229090818,2023-06-23 07:17:26,NemesisNemesi75,"Le réalisateur Nicolas Bedos placé en garde à vue pour agression sexuelle sur une jeune femme de 25 ans. L’agression s’est produite sur une piste de danse dans la discothèque Sauvages, située dans le 1er arrondissement de la capitale. 

Devant les enquêteurs, le réalisateur a…",13,51,9,73
939,1672141337922007041,2023-06-23 07:15:36,NemesisNemesi75,"Le réalisateur Nicolas Bedos placé en garde à vue pour agression sexuelle sur une jeune femme de 25 ans. L’agression s’est produite sur une piste de danse dans la discothèque Sauvages, située dans le 1er arrondissement de la capitale. 

Devant les enquêteurs, le réalisateur a…",74,284,51,409
940,1671597934494769157,2023-06-21 19:16:19,NemesisNemesi75,https://www.lefigaro.fr/lyon/lyon-10-000-euros-d-amende-requis-contre-damien-rieu-pour-diffamation-envers-karim-benzema-20230620,21,81,20,122
941,1671597932557025281,2023-06-21 19:16:18,NemesisNemesi75,"En France, si vous dénoncez le fait qu’une star mondiale du foot like une publication qui justifie la décapitation de Samuel Paty et les attentats djihadistes, c’est vous qui pouvez vous retrouver au tribunal. 🤡

Courage à @DamienRieu, verdict le 19 septembre",572,1953,130,2655
942,1671593604836384768,2023-06-21 18:59:06,NemesisNemesi75,"Vous pouvez être certains que si cette jeune femme avait fait un témoignage sur des violences policières, toutes les ""féministes"" médiatiques comme @sandrousseau et compagnie auraient immédiatement relayé sa vidéo, toutes. Mais à cause des 15 dernières secondes de la vidéo de… « CassissL: https://twitter.com/CassissL/status/1670757148727427073/video/1 — https://twitter.com/cassissl/status/1670757148727427073 »",428,1550,29,2007
943,1671588071748378626,2023-06-21 18:37:07,NemesisNemesi75,Ça ne plaira pas à certains mais c’est (encore) la réalité qui est décrite ici: des hommes noirs ont attaqué cette jeune femme à Nantes (encore) ainsi que les amis de cette jeune femme. « CassissL: https://twitter.com/CassissL/status/1670757148727427073/video/1 — https://twitter.com/cassissl/status/1670757148727427073 »,284,971,54,1309
944,1671562699522678784,2023-06-21 16:56:18,NemesisNemesi75,https://www.leparisien.fr/paris-75/une-jeune-fille-handicapee-agressee-sexuellement-en-plein-paris-21-06-2023-PVNTC6IX7ZHNFBNM42YRPE2AAA.php,34,64,3,101
945,1671562698012622857,2023-06-21 16:56:17,NemesisNemesi75,Un Afghan a agressé sexuellement une jeune fille handicapée en fauteuil roulant dans la nuit de mardi à ce mercredi. L’agresseur a aussi tenté de dérober la voiture. Il s’est mis à crier « Allah Akbar » à plusieurs reprises quand il a été interpellé par la police municipale.,268,668,25,961
946,1671491904880377856,2023-06-21 12:14:59,NemesisNemesi75,@sowsurlatrack Est-ce si difficile à concevoir qu’on ne veut des mains aux fesses de la part d’absolument personne ?,0,11,1,12
947,1671460265248866304,2023-06-21 10:09:16,NemesisNemesi75,"@riifaiin Cher Rachid, je pense que vous avez en réalité très bien compris le principe de notre message, nous n’allons pas vous faire l’affront de vous l’expliquer et insulter ainsi votre intelligence. #NotAllRachids",2,62,11,75
948,1671458941308469248,2023-06-21 10:04:00,NemesisNemesi75,@sowsurlatrack bah non,0,4,1,5
949,1671458579776241665,2023-06-21 10:02:34,NemesisNemesi75,"@LaGrottedeBeno Parler de tout n’est justement pas occulter. 

Si vous connaissez des femmes elles vous diront qu’elles sont bien plus emmerdées dans la rue par des Rachid que par des Robert c’est tout. 

Ça ne veut pas dire qu’il n’y ait aucun Robert qui emmerde les femmes dans la rue ça veut…",6,33,6,45
950,1671455182306136064,2023-06-21 09:49:04,NemesisNemesi75,"@LaGrottedeBeno Notre tweet à ce sujet datant de février 2023 devrait vous renseigner . Nous on occulte pas les faits selon la couleur de peau de l’agresseur ;) « NemesisNemesi75: Dominique P., qui droguait et faisait violer sa femme, aurait pu être neutralisé dès 2010 : la génétique le désignait dans un « cold case » dès 2010. Mais l’information, jamais exploitée, lui a permis d’échapper à la justice et de poursuivre ses méfaits. 
https://www.leparisien.fr/amp/faits-divers/dominique-p-le-mari-qui-droguait-et-faisait-violer-sa-femme-aurait-pu-etre-neutralise-des-2010-14-02-2023-X2E4MR4VWBDYDAQXELQNXQ7LBM.php — https://twitter.com/nemesisnemesi75/status/1625839851177123840 »",15,113,4,132
951,1671452135085465600,2023-06-21 09:36:57,NemesisNemesi75,"« Une réalité peut être illégale ». 🙃🙃🙃 « sowsurlatrack: @SPieriste @NemesisNemesi75 Une réalité doit être démontrée, y’a juste aucun moyen de démontrer ce qu’elles avances 

Une réalité peut être illégale — https://twitter.com/sowsurlatrack/status/1671427704795586562 »",18,125,9,152
952,1671418517567033344,2023-06-21 07:23:22,NemesisNemesi75,"Bref, si on a le droit de dire que Jean-Michel harcèle dans la rue, on doit aussi pouvoir dire que Rachid et ses potes le font.

😘",133,1040,27,1200
953,1671418514618343425,2023-06-21 07:23:21,NemesisNemesi75,Voici la réalité quand un homme se déguise en femme pendant une journée : https://twitter.com/NemesisNemesi75/status/1671418514618343425/video/1,179,548,18,745
954,1671418457093488640,2023-06-21 07:23:08,NemesisNemesi75,Voilà la réalité quand elle est filmée par des femmes dans la vraie vie et pas dans un spot publicitaire créé par une direction artistique totalement hors sol : https://twitter.com/NemesisNemesi75/status/1671418457093488640/video/1,498,1140,60,1698
955,1671418399124074497,2023-06-21 07:22:54,NemesisNemesi75,"Bon, c’est bien beau tout ça mais qu’en est-il quand ces scènes sont filmées dans la vie réelle ?

Voilà la réalité de nos militantes : https://twitter.com/NemesisNemesi75/status/1671418399124074497/video/1",134,461,10,605
956,1671418330786217984,2023-06-21 07:22:38,NemesisNemesi75,"Ici, ""Have a word"", une campagne contre le harcèlement de rue anglaise où l’agresseur est blanc et bien sûr il va se faire recarder par son ami noir pour son mauvais comportement. 🙃 https://twitter.com/NemesisNemesi75/status/1671418330786217984/video/1",48,304,11,363
957,1671418271071981571,2023-06-21 07:22:23,NemesisNemesi75,N’oublions pas la campagne complètement ratée de @clj_lille 🙃 https://twitter.com/NemesisNemesi75/status/1671418271071981571/photo/1,38,354,9,401
958,1671418265254469633,2023-06-21 07:22:22,NemesisNemesi75,Campagne financée par la mairie de @Bordeaux https://twitter.com/NemesisNemesi75/status/1671418265254469633/photo/1,59,362,14,435
959,1671418258648440833,2023-06-21 07:22:20,NemesisNemesi75,Campagne STAND UP financée par @lorealparis : https://twitter.com/NemesisNemesi75/status/1671418258648440833/video/1,46,303,13,362
960,1671418201421275138,2023-06-21 07:22:07,NemesisNemesi75,"Actuellement, les campagnes de prévention contre le harcèlement de rue ne désignent que les hommes blancs comme unique agresseurs. 

Les réalisateurs de ces spots vivraient-ils dans une réalité parallèle où les minorités ethniques sont incapables de harcèlement ? Quelle chance !…",89,636,14,739
961,1671418188897083392,2023-06-21 07:22:04,NemesisNemesi75,"⚠️THREAD À DEROULER:👌🏼

Depuis hier, notre affichage en réponse à la mairie de #Nantes concernant sa campagne contre le harcèlement de rue a suscité de nombreuses réactions et questions :

« Pourquoi avoir désigné Rachid et ses potes » nous demande un internaute ? 

Et pourquoi… « NemesisNemesi75: Vous avez oublié la notre @Johanna_Rolland https://twitter.com/NemesisNemesi75/status/1671071774786609152/photo/1 — https://twitter.com/nemesisnemesi75/status/1671071774786609152 »",629,2287,130,3046
962,1671089096712761345,2023-06-20 09:34:22,NemesisNemesi75,"Nous notons d’ailleurs qu’@EstherBenbassa , une femme se revendiquant féministe qui défend corps et âme l’accueil inconditionnel d’hommes issus de sociétés ultra-patriarcales. Incroyable. « CordierAlice2: Je serai sur Cnews dans quelques minutes pour parler de l’agression de @NemesisNemesi75 par des militants d’Utopia 56 — https://twitter.com/cordieralice2/status/1671083783922016256 »",36,124,8,168
963,1671071774786609152,2023-06-20 08:25:32,NemesisNemesi75,"Vous avez oublié la notre @Johanna_Rolland https://twitter.com/NemesisNemesi75/status/1671071774786609152/photo/1 « Johanna_Rolland: #NantesZeroSexisme #8mars
A #Nantes 👉 Objectif Zéro Sexisme !
Fière de cette belle campagne d’information et de sensibilisation contre les inégalités, les stéréotypes de genre, le harcèlement dans la rue et les transports. Vous ne l'avez pas encore vue ? 🤔 Retrouvez-la ici 👇 https://twitter.com/Johanna_Rolland/status/1633519024561692696/photo/1 — https://twitter.com/johanna_rolland/status/1633519024561692696 »",700,3764,481,4945
964,1671062620382674945,2023-06-20 07:49:10,NemesisNemesi75,"La mairie de #Nantes a lancé une campagne contre le harcèlement de rue, récurent dans cette ville. Nous avons donc souhaité compléter cette campagne. 🙃

➡️Lutter contre le harcèlement de rue c’est bien, ne pas occulter la vérité c’est mieux ! https://twitter.com/NemesisNemesi75/status/1671062620382674945/photo/1",494,1879,99,2472
965,1671055919357075459,2023-06-20 07:22:32,NemesisNemesi75,https://actu.fr/nouvelle-aquitaine/marmande_47157/a-peine-condamne-pour-agression-sexuelle-il-recidive-en-attendant-son-train-pour-marmande_59750040.html,19,56,1,76
966,1671055917234749451,2023-06-20 07:22:32,NemesisNemesi75,"Cedric X., a été condamné mercredi 14 juin 2023 par le tribunal correctionnel de Nantes pour « agression sexuelle en état d’ivresse manifeste » après avoir caressé la poitrine d’une femme de 19 ans  qui attendait devant lui dans la file d’attente d’une sandwicherie à la gare de…",67,288,16,371
967,1671053246239068160,2023-06-20 07:11:55,NemesisNemesi75,"Le procès en appel de Jean-Marc Reiser s’ouvre aujourd’hui devant la cour d'assises de Colmar. Il a assassiné Sophie Le Tan, une étudiante, en septembre 2018. Elle venait visiter l’appartement de Jean-Marc Reiser à Schiltigheim, en Alsace. Son corps n’a été retrouvé que treize… https://twitter.com/NemesisNemesi75/status/1671053246239068160/photo/1",65,265,17,347
968,1670916194780545026,2023-06-19 22:07:19,NemesisNemesi75,Par rapport à la vidéo de #Bordeaux sachez que ces commentaires existent : https://twitter.com/NemesisNemesi75/status/1670916194780545026/photo/1,652,1711,77,2440
969,1670900026040545281,2023-06-19 21:03:04,NemesisNemesi75,"D’après @InfosBordeaux , l’agresseur a été interpellé et il serait déjà connu des services de police. Nous espérons que les deux victimes de cette agression vont bien. https://twitter.com/NemesisNemesi75/status/1670900026040545281/video/1",275,808,85,1168
970,1670713849551417344,2023-06-19 08:43:16,NemesisNemesi75,"Nous ne sommes que lundi, et déjà  près d’une dizaine de crimes et délits touchant des femmes, partout en France et en Europe. 

La presse appelle cela « faits divers » alors que la violence sur les femmes c’est un fait de société.

Sachez d’ailleurs que cette liste n’est pas…",105,224,8,337
971,1670706987883982849,2023-06-19 08:16:00,NemesisNemesi75,"Â Brest, une femme d’une trentaine d’années a été transportée en urgence absolue à l’hôpital après avoir reçu des coups de couteau, ce dimanche 18 juin 2023. Son ex-conjoint aurait été interpellé par la police. 

https://www.ouest-france.fr/societe/faits-divers/a-brest-une-femme-gravement-blessee-au-couteau-par-son-ex-conjoint-00f20666-0dd0-11ee-891e-aa538ff341aa",87,129,6,222
972,1670705452223430663,2023-06-19 08:09:54,NemesisNemesi75,https://actu.fr/ile-de-france/mantes-la-jolie_78361/mantes-la-jolie-agression-sexuelle-dans-les-toilettes-d-un-festival_59746709.html,17,31,0,48
973,1670705449845358594,2023-06-19 08:09:54,NemesisNemesi75,"À Mantes-la-Jolie (Yvelines), dans la nuit du 17 au 18 juin 2023, une jeune femme a été victime d'une agression sexuelle en marge d'un festival gratuit consacré aux sports de glisse.

La jeune femme a crié et le mis en cause a pu être intercepté par un fonctionnaire hors service…",66,171,2,239
974,1670703616645033986,2023-06-19 08:02:37,NemesisNemesi75,"Le trentenaire qui a brûlé une femme dans la nuit de jeudi à vendredi à Borrèze en Dordogne a été mis en examen et placé en détention provisoire ce dimanche matin. Il est poursuivi pour tentative de meurtre sur concubine et tentative de viol. 

https://www.francebleu.fr/infos/faits-divers-justice/l-homme-qui-a-brule-sa-voisine-en-dordogne-est-mis-en-examen-pour-tentative-de-meurtre-et-tentative-de-viol-6919470",53,92,1,146
975,1670702820327030784,2023-06-19 07:59:27,NemesisNemesi75,"Une jeune femme qui était portée disparue depuis le 9 juin dernier a été retrouvée morte dans un squat du 7e arrondissement de Lyon.

Un suspect âgé d’une trentaine d’années, et qui vivait dans ce squat, a été interpellé par les forces de l’ordre et placé en garde à vue au…",23,50,0,73
976,1670700283851075584,2023-06-19 07:49:22,NemesisNemesi75,"« Je prends l’argent, je viole » 

a dit Jeson Locko, condamné  jeudi dernier à 14 ans de réclusion criminelle. 

Pour la série de neuf extorsions - ou tentatives - sur des parkings de Riorges (Loire), pour l'agression sexuelle et le viol d'une jeune femme, en fin d'année 2020.… https://twitter.com/NemesisNemesi75/status/1670700283851075584/photo/1",236,438,37,711
977,1670698084613996545,2023-06-19 07:40:38,NemesisNemesi75,https://www.leparisien.fr/amp/yvelines-78/yvelines-une-femme-dune-trentaine-dannees-poignardee-a-la-gorge-a-meulan-un-homme-interpelle-17-06-2023-I6KZW25N2FEU5EFI4P3R6H7XQA.php,13,32,1,46
978,1670698083108151296,2023-06-19 07:40:37,NemesisNemesi75,"« J’ai égorgé ma femme » a affirmé le compagnon de Julie, une femme d’une trentaine d’années et mère d’un bébé de 4 mois. Elle a été tuée à Meulan dans les Yvelines samedi dernier.

Son compagnon a été arrêté par la police. L’homme n'était pas connu pour des antécédents de…",94,285,21,400
979,1670695538415501312,2023-06-19 07:30:31,NemesisNemesi75,"« Il voulait tuer mon bébé » : une femme enceinte de huit mois agressée en Ardèche. Son agresseur,  Malik H. , un tunisien en situation irrégulière a été libéré après sa garde à vue.

Mais rassurez-vous : il fait maintenant l’objet d’une OQTF 🙄

https://www.valeursactuelles.com/faits-divers/il-voulait-tuer-mon-bebe-une-femme-enceinte-de-huit-mois-blessee-en-ardeche-son-agresseur-tunisien-et-clandestin-libere",115,200,8,323
980,1670692270079606790,2023-06-19 07:17:31,NemesisNemesi75,"Le corps d’Anastasia Rubinska, une employée d'hôtel Polonaise a été retrouvé dimanche après-midi dans la région d'Alykes sur l'île de Kos, en Grèce.

Le principal suspect est son colocataire,  un ressortissant pakistanais. La police a trouvé chez lui des mèches de cheveux blonds,… https://twitter.com/NemesisNemesi75/status/1670692270079606790/photo/1",822,1902,160,2884
981,1670685910319480835,2023-06-19 06:52:15,NemesisNemesi75,"Pas d’expulsion prévue pour Louai Alali, un Syrien en situation irrégulière qui bat à coups de bâton et de ceinture sa femme Imam, en France depuis 3 mois.

L’avocate de l’accusée plaide le ""fossé culturel important entre la Syrie et la France"".

https://www.laprovence.com/article/region/49162521084588/manosque-il-frappe-sa-femme-a-coups-de-batons-et-de-ceinture https://twitter.com/NemesisNemesi75/status/1670685910319480835/photo/1",114,165,27,306
982,1670504352446836738,2023-06-18 18:50:48,NemesisNemesi75,@jylgallou Nous savons bien que c’est la norme et qu’ils sont bien tous formatés dans leurs écoles de journalisme malheureusement.,0,10,0,10
983,1670374044535758849,2023-06-18 10:13:00,NemesisNemesi75,@ArpegeLA1931 @DamienRieu @Margueritestern « Le féminisme est comme une pieuvre » blablabla. Que trouvez-vous de si effrayant chez les femmes qui demandent simplement qu’on arrête de les agresser très exactement ? Excusez-nous de vouloir mettre fin à ce genre de problèmes vraiment 🤡,0,1,1,2
984,1670372135879991296,2023-06-18 10:05:25,NemesisNemesi75,"@Margueritestern Nous n’avons jamais vu personne à droite nier le fait que les hommes constituent l’immense majorité des personnes incarcérés. Il serait difficile de le nier étant donné que les statistiques à ce sujet sont disponibles :

«On comptait, au 31 mars 2022, environ 85 136 détenus…",10,149,2,161
985,1670351434259283969,2023-06-18 08:43:10,NemesisNemesi75,@UseHerName4 @OuestFrance Ah oui quand même. Osée celle-là aussi.,1,9,0,10
986,1670346449106747394,2023-06-18 08:23:21,NemesisNemesi75,"""Des invectives de part et d’autre"" explique @francebleu. 

De simples «heurts» pour le journal @lemondefr.

 Une dédicace «perturbée» nous dit @leparisien_pol.

Incroyable ces euphémismes concernant ce qui s’est passé hier à #Brest pour la dédicace de @ZemmourEric , incluant des… https://twitter.com/NemesisNemesi75/status/1670346449106747394/photo/1",795,1889,69,2753
987,1670321635969097728,2023-06-18 06:44:45,NemesisNemesi75,"Parce que nous ne serions pas les filles que nous sommes sans les pères que nous avons ou que nous avons eu. 

Bonne #fetedesperes ! 💙💙💙 https://twitter.com/NemesisNemesi75/status/1670321635969097728/photo/1",73,486,14,573
988,1669615496117862400,2023-06-16 07:58:48,NemesisNemesi75,"« J’ai été l’objet de pressions de la part de féministes, qui disaient qu’il ne fallait pas donner l’origine des agresseurs »

confie Isabelle Gillette-Faye, directrice générale de la fédération Gams (Groupe pour l’abolition des mutilations sexuelles, des mariages forcés et… https://twitter.com/NemesisNemesi75/status/1669615496117862400/photo/1",235,515,8,758
989,1669609281677582338,2023-06-16 07:34:07,NemesisNemesi75,"Hier à Saint-Ouen-l’Aumône, un homme a tiré sur sa femme en pleine rue. Il en ensuite tenté de se suicider. Le pronostic vital de la femme de 60 ans est engagée. 

Les secours ont également pris en charge 23 personnes, dont des mineurs, particulièrement choquées après avoir été…",11,51,1,63
990,1669603662908334080,2023-06-16 07:11:47,NemesisNemesi75,"Depuis plus de 3 mois, Michel Pialle, le mari de Karine Esquivillon savait : il avait pourtant nié toute implication dans la disparition de sa femme face caméra et avait suggéré que celle-ci était partie avec un autre homme en abandonnant ses enfants.

Le corps de la mère de… https://twitter.com/NemesisNemesi75/status/1669603662908334080/photo/1",93,350,29,472
991,1669596432788070403,2023-06-16 06:43:03,NemesisNemesi75,"Hier, des militantes du Collectif Némésis se sont rendues à l’école de la rue Erlanger dans le 16eme arrondissement, toujours occupée par l’association @Utopia_56 qui y logent illégalement 600 migrants. 

En avril dernier, lors d’une action pacifique de notre association pour… https://twitter.com/NemesisNemesi75/status/1669596432788070403/video/1",576,1236,61,1873
992,1669278353004589057,2023-06-15 09:39:07,NemesisNemesi75,"Retrouvez tous nos témoignages sur notre chaîne Youtube :  

https://m.youtube.com/@nemesisparis1045/videos",18,40,1,59
993,1669278351570219010,2023-06-15 09:39:07,NemesisNemesi75,"Si vous souhaitez nous aider, vous pouvez nous faire un don sur Paypal à l’adresse collectif.nemesis@outlook.fr ou en suivant ce lien :

https://www.paypal.com/donate/?cmd=_s-xclick&hosted_button_id=3YKTNP3ARC5CJ&source=url",23,48,5,76
994,1669278345828130817,2023-06-15 09:39:05,NemesisNemesi75,"🛑En 2020, Augustin intervient pour stopper une scène de harcèlement à Lyon : 4 jeunes femmes subissent les demandes lourdes et insistantes de 5 jeunes d’origine africaine pour obtenir leurs numéros de téléphone alors qu’elles ne sont pas intéressées. 

Il sera roué de coups par… https://twitter.com/NemesisNemesi75/status/1669278345828130817/video/1",813,1780,83,2676
995,1669263970400600064,2023-06-15 08:41:58,NemesisNemesi75,"Avoir la force de quitter son conjoint violent et vivre dans un foyer d’urgence ?  

C’est ce qu’a réussi à faire Nelly Pauchet, mère de 5 enfants avant d’être poignardée à mort en pleine rue près d’Amiens ce week-end.

Son corps a été découvert à proximité d'un foyer d’urgence… https://twitter.com/NemesisNemesi75/status/1669263970400600064/photo/1",495,899,92,1486
996,1669259095336005634,2023-06-15 08:22:36,NemesisNemesi75,"Faut-il attendre que Lucile finisse par être tuée pour qu’enfin la justice mette Florian Telle derrière les barreaux ? 

Florian Telle a été condamné deux fois pour avoir envoyé de multiples menaces de mort à Lucile, une Tiktokeuse. 

Il lui a notamment dit par téléphone : « Si… https://twitter.com/NemesisNemesi75/status/1669259095336005634/photo/1",406,877,91,1374
997,1669249600887160833,2023-06-15 07:44:52,NemesisNemesi75,"Abdelmounaim Mhamdi écope 28 années de réclusion criminelle, pour le meurtre de son épouse, Hanane Abdelkhalek, le 28 juillet 2020 près de Lyon.

https://www.leprogres.fr/amp/faits-divers-justice/2023/06/06/feminicide-a-la-mulatiere-28-ans-de-reclusion-criminelle-pour-l-accuse",16,32,3,51
998,1669241573459066883,2023-06-15 07:12:58,NemesisNemesi75,"Bernard Lopes, 46 ans,  a été condamné à 25 ans de prison pour avoir tenté d’égorger sa compagne à Toulouse en 2021. Sa compagne voulait le quitter.  

https://www.ladepeche.fr/2023/06/13/25-ans-de-reclusion-pour-avoir-tente-degorger-sa-compagne-a-toulouse-11260643.php",28,92,4,124
999,1668976068022116357,2023-06-14 13:37:57,NemesisNemesi75,"Un migrant guinéen SDF suit une jeune femme et se masturbe devant elle. Il a été interpellé dans le quartier de la Guillotière à Lyon.

https://www.lyonmag.com/article/130578/lyon-1er-en-pleine-nuit-il-suit-une-jeune-femme-seule-puis-se-masturbe-devant-elle",393,648,100,1141
1000,1668903591359258631,2023-06-14 08:49:57,NemesisNemesi75,https://www.bfmtv.com/amp/police-justice/disparition-de-karine-esquivillon-son-mari-place-en-garde-a-vue_AN-202306140283.html,11,34,3,48
1001,1668728243233357825,2023-06-13 21:13:11,NemesisNemesi75,"Aujourd’hui à Berne en Suisse, 7 militantes du Collectif Némésis étaient attablées dans un restaurant après une action pendant la grève féministe Suisse quand elles ont été violemment agressées par un groupe d’une vingtaine d’hommes antifas cagoulés. 

Jet de chaises et tables… https://twitter.com/NemesisNemesi75/status/1668728243233357825/video/1",1888,3805,744,6437
1002,1668591663361523720,2023-06-13 12:10:28,NemesisNemesi75,"Kilian Leroux a été condamné le 7 juin à deux ans de prison dont un an ferme pour avoir agressé sexuellement une jeune femme lors d'une soirée à Hambye, alors que la victime dormait. Il devra porter un bracelet électronique. 

https://www.lamanchelibre.fr/amp-1062331-hambye-une-jeune-femme-victime-d-une-agression-sexuelle-alors-qu-elle-dormait.html",20,47,1,68
1003,1668588487673520130,2023-06-13 11:57:50,NemesisNemesi75,"Vienne : un septuagénaire vient d’être placé sous contrôle judiciaire, dans l’attente de son procès. Il sera poursuivi pour des attouchements commis sur une jeune fille de 13 ans à un arret de bus 

https://www.ledauphine.com/faits-divers-justice/2023/06/12/isere-vienne-un-septuagenaire-sous-controle-judiciaire-apres-l-agression-sexuelle-d-une-adolescente",10,20,0,30
1004,1668514922706227203,2023-06-13 07:05:31,NemesisNemesi75,"Quand vous lisez un article d’un quotidien «neutre» comme @20Minutes , il y a de fortes chances pour que celui-ci soit écrit par un homoncule gauchiste du même acabit que ce @XavRegnier. Ils sont légion dans cette profession.",25,142,3,170
1005,1668513315864100865,2023-06-13 06:59:08,NemesisNemesi75,"L’une des intervenantes Virginie Spies, dans l’article indique (et espère ?) :  «Il va peut-être tomber de son piédestal plus vite qu’il n’y est monté».

Quel est ce besoin mortifère de vouloir absolument souiller un acte aussi héroïque ?",22,160,3,185
1006,1668510586496335872,2023-06-13 06:48:17,NemesisNemesi75,"Le journaliste @XavRegnier sur son Twitter se définit lui-même comme un  «Social journalist warrior», un jeu de mot avec SJW (social justice warrior) qui signifie «gauchiste» dans le contexte anglo-saxon. https://twitter.com/NemesisNemesi75/status/1668510586496335872/photo/1",24,135,6,165
1007,1668510580561309698,2023-06-13 06:48:16,NemesisNemesi75,"« Henri et... ses points communs avec Abdalmasih H. » 

«Henri n’en reste, tel Batman, pas moins un humain... avec son passé, son côté sombre et ses éventuelles casseroles. »

Dans un article ignoble dans le journal @20Minutes, @XavRegnier tente de souiller l’image d’Henri, le… https://twitter.com/NemesisNemesi75/status/1668510580561309698/photo/1",153,664,44,861
1008,1668171455639572481,2023-06-12 08:20:42,NemesisNemesi75,"Mort d’Iris à Lanester : le suspect, Christophe R., 48 ans, mis en examen pour meurtre et viol. Il avait déjà été condamné pour viol en 2015 et pour une affaire de vol de sous-vêtements féminins.

https://www.ouest-france.fr/societe/faits-divers/meurtre-diris-a-lanester-le-quinquagenaire-deja-condamne-pour-viol-mis-en-examen-pour-meurtre-08809d0c-0600-11ee-be86-c4e6f5ffafb7 https://twitter.com/NemesisNemesi75/status/1668171455639572481/photo/1",187,354,30,571
1009,1667985711906058240,2023-06-11 20:02:38,NemesisNemesi75,@Ereminette Merci beaucoup !,0,4,0,4
1010,1667828119405830145,2023-06-11 09:36:25,NemesisNemesi75,"Si toi aussi tu veux témoigner et ne plus avoir peur d’identifier tes agresseurs, contacte-nous à l’adresse : collectif.nemesis@outlook.fr

Si vous souhaitez nous aider, vous pouvez nous faire un don sur paypal à l’adresse collectif.nemesis@outlook.fr ou en suivant le lien en bio",26,82,1,109
1011,1667827972030578689,2023-06-11 09:35:49,NemesisNemesi75,"« Aujourd’hui Nantes la capitale historique de la Bretagne se transforme de plus en plus en Kaboul »

Melissa est Nantaise et elle a un message à faire passer à Johanna Rolland, la maire de Nantes. 

➡️Retrouvez son témoignage en intégralité sur notre chaîne Youtube (lien en… https://twitter.com/NemesisNemesi75/status/1667827972030578689/video/1",1284,2464,151,3899
1012,1667585072084529153,2023-06-10 17:30:38,NemesisNemesi75,"Une adolescente de 16 ans a été piégée, séquestrée et prostituée de force par son ex petit-ami qui est un délinquant de Marseille. Lors de l’intervention de la police, une autre jeune fille a été retrouvée, à peine consciente.

https://www.leparisien.fr/val-de-marne-94/champigny-sur-marne-une-ado-de-16-ans-sequestree-et-prostituee-pour-payer-la-dette-de-son-ex-10-06-2023-2Q6RHZ7DYBBW3NVZSIHMAU74F4.php",149,201,9,359
1013,1667499837716062210,2023-06-10 11:51:56,NemesisNemesi75,"Grèce: Manolis Kafetziadis, jeune grec amateur de sport de combat , a courageusement empêché le viol d’une jeune fille de 17 ans, par 4 égyptiens. Seul contre 4, il parvient à les faire fuir. Les migrants ont été arrêtés par la police. 

https://greekcitytimes.com/2023/06/08/karate-expert-saves-greek-girl-from-attempted-rape-by-four-egyptians/",662,2198,74,2934
1014,1667469535564234753,2023-06-10 09:51:32,NemesisNemesi75,"🛑 Procès d’Omar, le meurtrier de Shaina : l’accusé écope de 18 ans de réclusion seulement pour l’assassinat de l’adolescente de 15 ans poignardée et brûlée vive en 2019 à Creil.

Rappelons d’ailleurs que l’accusé en détention avait dit : “Je suis Musulman, je préfère prendre…",655,1493,84,2232
1015,1667278822662610946,2023-06-09 21:13:42,NemesisNemesi75,"Un collaborateur d’une sénatrice (parti Renaissance) a été placé en garde à vue. L’homme de 26 ans, également professeur à Science Po Paris,  est accusé par 6 femmes de violences, séquestration, viols et transmission volontaire de MST. 

https://www.lepoint.fr/faits-divers/violences-sexuelles-un-collaborateur-d-une-senatrice-renaissance-en-garde-a-vue-09-06-2023-2523700_2627.php",106,146,8,260
1016,1667277613075771392,2023-06-09 21:08:54,NemesisNemesi75,"“Arrêtez de me fatiguer, oui j'ai fait une tentative de viol”
“Tout ça pour une femme ... je n'ai tué personne"".  

A déclaré un Malien, lors de son audition pour agression sexuelle sur une policière à Lyon. Il a été condamné à 4 ans de prison.

https://www.lyonmag.com/article/130505/chaponost-un-malien-agresse-sexuellement-une-policiere-municipale-4-ans-de-prison-ferme",498,935,47,1480
1017,1667255257926193152,2023-06-09 19:40:04,NemesisNemesi75,"Puisque même les parcs deviennent des lieux de cauchemars, nous étions ce soir au Jardin du Luxembourg à Paris pour dénoncer les conséquences de l’immigration incontrôlée : https://twitter.com/NemesisNemesi75/status/1667255257926193152/photo/1",1096,3051,91,4238
1018,1667161508684414980,2023-06-09 13:27:32,NemesisNemesi75,"« Pensez aux familles, ce n’est pas le moment ». 

Les familles de ces enfants auraient été ravies de ne jamais croiser la route de cet homme qui n’avait rien à faire ici. Et toi tu n’aurais pas eu à penser à elles aujourd’hui @LouisBoyard. 

Ce qui s’est passé hier c’est le… « LouisBoyard: Je n’ai pas de mots assez justes pour décrire notre douleur après ce que s’est passé à #Annecy.

Pensées aux victimes, aux proches.

Et voir le @RNational_off et @auroreberge faire de la récupération, c’est écœurant.

S’il vous plaît, pensez aux familles, ce n’est pas le moment. — https://twitter.com/louisboyard/status/1666768581298626561 »",60,278,4,342
1019,1667118778189053953,2023-06-09 10:37:44,NemesisNemesi75,"« Ouvrir les frontières c’est fermer des cercueils »

Hier, nos militantes ont bravé l’interdiction préfectorale de rassemblement à Annecy pour aller rendre hommage aux victimes d’Abdalmasih H., un migrant syrien qui n’aurait jamais du se trouver ici. https://twitter.com/NemesisNemesi75/status/1667118778189053953/photo/1",829,2861,93,3783
1020,1667095234684043266,2023-06-09 09:04:11,NemesisNemesi75,"Rappelons d’ailleurs que l’ONDRP l'observatoire national de la délinquance et des réponses pénales a été dissous en décembre 2020 sous le gouvernement Macron. 

Cette structure produisait et diffusait des statistiques sur la criminalité et la délinquance. Une dissolution… https://twitter.com/NemesisNemesi75/status/1667095234684043266/photo/1",84,152,3,239
1021,1667078973514186754,2023-06-09 07:59:34,NemesisNemesi75,"Brive-la-Gaillarde : une travailleuse sociale gravement blessée à l'arme blanche ce jeudi matin. Il a utilisé une lance, avec une couteau au bout. Le suspect a été interpellé et placé en garde à vue.

https://www.francebleu.fr/infos/faits-divers-justice/brive-la-gaillarde-une-travailleuse-sociale-gravement-blessee-a-l-arme-blanche-ce-jeudi-matin-8172940",132,210,8,350
1022,1666878505693347883,2023-06-08 18:42:59,NemesisNemesi75,Tous ceux qui parlent de « récupération» sont irrécupérables.,77,375,15,467
1023,1666859507740291088,2023-06-08 17:27:30,NemesisNemesi75,@JeanReinfort @DamienRieu Merci pour ces mots si justes,10,75,2,87
1024,1666850712792313864,2023-06-08 16:52:33,NemesisNemesi75,"Aucune haine pour l’agresseur par contre.
La haine. « mariecchambel: La haine de voir l'extrême-droite se réapproprier le drame d'Annecy en appelant à manifester ce soir au Pâquier.
La haine. — https://twitter.com/mariecchambel/status/1666757588103442432 »",115,723,7,845
1025,1666844120059453442,2023-06-08 16:26:21,NemesisNemesi75,"Aujourd’hui un migrant syrien a tenté de tuer plusieurs enfants. 

Aujourd’hui un Marocain de 30 ans est jugé à Montpellier pour une attaque au couteau sur une femme de 50 ans.

Hier, un Algérien écopait d’un an de prison pour une agression sexuelle à Vaulx-en-Velin.

Hier, Jamel…",2545,5378,193,8116
1026,1666827596179423232,2023-06-08 15:20:41,NemesisNemesi75,#Annecy https://twitter.com/NemesisNemesi75/status/1666827596179423232/photo/1,380,924,11,1315
1027,1666811742972968966,2023-06-08 14:17:42,NemesisNemesi75,Parce qu’ils ne nous feront pas taire: ce soir rassemblement à #Annecy 20h30 à Bonlieu https://twitter.com/NemesisNemesi75/status/1666811742972968966/photo/1,191,426,11,628
1028,1666429684928708608,2023-06-07 12:59:32,NemesisNemesi75,"Un Algérien écope d’un an ferme pour une main aux fesses. 

Les faits remontent au 9 avril: une jeune femme déambulait dans le marché aux puces de Vaulx-en-Velin lorsqu’elle sentit un homme se glisser derrière elle et lui empoigner la fesse droite. 

Interpellé par les vigiles du… https://twitter.com/NemesisNemesi75/status/1666429684928708608/photo/1",117,372,31,520
1029,1666421956852187137,2023-06-07 12:28:49,NemesisNemesi75,"Lyon : armé d’un couteau, il suit une jeune femme dans son immeuble et tente de la violer 

https://www.lyonmag.com/article/130444/lyon-arme-d-un-couteau-il-suit-une-jeune-femme-dans-son-immeuble-et-tente-de-la-violer",163,201,6,370
1030,1666406147690037251,2023-06-07 11:26:00,NemesisNemesi75,"Safir Zamoum, un aide soignant en interim, condamné à 8 ans de prison ferme pour le viol dans un Ehpad d’une femme handicapée de 68 ans 

https://www.estrepublicain.fr/amp/faits-divers-justice/2023/06/06/viol-sur-une-personne-handicapee-a-l-ehpad-8-ans-de-prison-ferme-pour-l-aide-soignant",75,96,3,174
1031,1666366812248735746,2023-06-07 08:49:42,NemesisNemesi75,https://www.leparisien.fr/faits-divers/paralysee-entravee-et-noyee-un-vendeure-de-brochettes-accuse-du-meurtre-atroce-dune-escort-girl-07-06-2023-O6VBPCV2YBF2DDD5UCLLKYCHMA.php,6,22,0,28
1032,1666366752454746113,2023-06-07 08:49:28,NemesisNemesi75,"🛑Alassane S. , jugé pour le meurtre d’Anne Laure, escort-girl de 23 ans avec qui il avait rendez-vous le 23 octobre 2019.

L’autopsie a révélé que la jeune femme, entravée avec 40 m de film alimentaire, des sacs plastique et un cordon électrique, est morte noyée. 

La submersion…",146,344,13,503
1033,1666355233243426817,2023-06-07 08:03:41,NemesisNemesi75,"Dans le Doubs, un homme de 26 ans soupçonné du viol d'une octogénaire dans un hôpital 

https://www.femmeactuelle.fr/actu/news-actu/dans-le-doubs-un-homme-de-26-ans-soupconne-du-viol-dune-octogenaire-dans-un-hopital-2156530",17,36,1,54
1034,1666030314647433217,2023-06-06 10:32:35,NemesisNemesi75,"Ishak Belfodil, un footballeur algérien interpellé dans les Yvelines et placé en garde à vue pour des violences sur sa sœur de 15 ans. 

L’affaire est classée sans suite malgré une tentative d’étranglement de l’homme de 31 ans sur la jeune femme mineure.

https://www.cnews.fr/sport/2023-06-05/football-un-international-algerien-place-en-garde-vue-pour-tentative-de-meurtre-sur",84,123,3,210
1035,1666006748618948608,2023-06-06 08:58:56,NemesisNemesi75,"Situation totalement GROTESQUE dont notre pays a le secret:

Jamel Amamari, un migrant tunisien qui avait déjà été condamné pour des vols à l’arraché de bijoux une nouvelle fois condamné. Il avait pourtant été expulsé vers son pays d’origine mais est revenu en Europe, “à cause de…",88,207,0,295
1036,1665947354715897858,2023-06-06 05:02:55,NemesisNemesi75,"Les Algériens 🇩🇿 veulent brandir leur drapeau dans absolument toutes les manifestations... sauf à la «pride des banlieues» 🏳️‍🌈🏳️‍⚧️ où un homme ordonne à une femme de l’enlever sinon il va « niquer sa mère ».

Encore une preuve éclatante que l’intersectionalité dont l’immense… https://twitter.com/NemesisNemesi75/status/1665947354715897858/video/1",511,1602,132,2245
1037,1665650970875887618,2023-06-05 09:25:12,NemesisNemesi75,"Le profil du cambrioleur dans le spot publicitaire de l’entreprise Sector Alarme est au moins aussi convaincant que le profil des harceleurs dans la campagne contre le harcèlement de rue de la mairie de Bordeaux vous ne trouvez pas ? 🙃 

Dans la pub il y a  de la diversité… https://twitter.com/NemesisNemesi75/status/1665650970875887618/video/1",583,1694,98,2375
1038,1665641269278777346,2023-06-05 08:46:39,NemesisNemesi75,"Émouvant témoignage de @moicestyasin , le frère de Shaina sur TF1.

Le procès d’Omar, l’assassin de Shaina qui avait 17 ans au moment des faits débute aujourd’hui. Nous espérons que l’excuse de minorité ne s’appliquera pas et que le verdict sera exemplaire. 

#Quitter son… « 7a8: Pendant 2 ans, sans parvenir à lui épargner ce cauchemar, Yasin, le frère de Shaïna, savait tout : violences physiques, sexuelles, jusqu’à la mort. Shaïna a été poignardée et brûlée vive, à 15 ans. 

A la veille du procès de l’assassin présumé, il se confie à @audrey_crespo. https://twitter.com/7a8/status/1665413857676779520/video/1 — https://twitter.com/7a8/status/1665413857676779520 »",36,158,6,200
1039,1665594245711896577,2023-06-05 05:39:48,NemesisNemesi75,"Rami Adwan, ambassadeur du Liban en France visé par une enquête pour viol et violences après des plaintes de deux ex-employées de l'ambassade.

Le viol se serait déroulé en mai 2020 dans l'appartement privé de l'ambassadeur. La jeune-femme de 31 ans indique avoir refusé un… https://twitter.com/NemesisNemesi75/status/1665594245711896577/photo/1",41,105,7,153
1040,1665592476961329152,2023-06-05 05:32:46,NemesisNemesi75,"Affaire Mohamed Haouas : ""Nous ne le laisserons pas tomber Je connais ce garçon depuis son adolescence. On est allé le chercher plusieurs fois au poste. La dernière fois, c'est Yacouba Camara qui s'en est chargé."" 

Mohed Altrad, président du Montpellier Herault Rugby soutient le… https://twitter.com/NemesisNemesi75/status/1665592476961329152/photo/1",15,36,4,55
1041,1665590309625929728,2023-06-05 05:24:09,NemesisNemesi75,"Elle s’appelait Aline Bouhier-Tricoire et son histoire ne fera pas la une des journaux : elle fait pourtant partie des 47 femmes tuées par leurs compagnons depuis le 1er janvier de cette année. 

Tous les ans, c’est plus d’une centaine de femmes qui meurent dans ces conditions.… https://twitter.com/NemesisNemesi75/status/1665590309625929728/photo/1",66,157,4,227
1042,1665585148463644672,2023-06-05 05:03:39,NemesisNemesi75,"Un homme déjà connu de la justice frappe à coups de marteau le nouveau compagnon de son ex-femme puis enlève et séquestre cette dernière. Il a été interpellé par le Raid près de Grenoble.

https://france3-regions.francetvinfo.fr/auvergne-rhone-alpes/isere/grenoble/un-homme-enleve-son-ex-compagne-et-attaque-son-petit-ami-a-coups-de-marteau-il-est-interpelle-par-le-raid-pres-de-grenoble-2787714.html",17,30,3,50
1043,1665233082234830849,2023-06-04 05:44:39,NemesisNemesi75,💙Bonne fête à toutes les mères💙 #fetedesmeres https://twitter.com/NemesisNemesi75/status/1665233082234830849/photo/1,38,260,1,299
1044,1664637832411979778,2023-06-02 14:19:21,NemesisNemesi75,"« Personnellement, c’est toujours par des personnes de type maghrébine que je me fais suivre ou que je me fait siffler ou insulter » explique Léa, 20 ans. 

Qu’en pensez-vous? Partagez-vous son constat sur le harcèlement de rue? 

Dites-nous tout en commentaire ! ⬇️ https://twitter.com/NemesisNemesi75/status/1664637832411979778/video/1",1530,3763,402,5695
1045,1664570973075456002,2023-06-02 09:53:40,NemesisNemesi75,@JulietteBriens @sandrousseau @Clem_Autain Sûrement parce que la lutte contre les violences sexistes et conjugales ne sont pas vraiment leurs priorités en réalité,2,17,0,19
1046,1664570072801615873,2023-06-02 09:50:06,NemesisNemesi75,"Adil Miloudi, un ressortissant marocain de 41 ans reconnu coupable de violences aggravées. Il a porté des coups de cutter à sa compagne ukrainienne, toujours hospitalisée à Ajaccio où elle avait été transportée lundi par les services de secours. https://www.corsematin.com/articles/femme-blessee-a-larme-blanche-son-compagnon-condamne-a-8-ans-de-prison-ferme-142729",24,39,2,65
1047,1664568733908578304,2023-06-02 09:44:47,NemesisNemesi75,"Une femme de 26 ans a déposé plainte en août 2022 contre Yuz Boy (Youssouf Keita de son vrai nom) gagnant de la saison 2 de ""Nouvelle école"", la compétition rap de @NetflixFR dont la finale a été diffusée mercredi.

Le parquet de Paris a ouvert une enquête après qu'elle a dénoncé… https://twitter.com/NemesisNemesi75/status/1664568733908578304/photo/1",31,64,4,99
1048,1664255696492191744,2023-06-01 13:00:53,NemesisNemesi75,"Ce jeudi, Djibril et deux autres hommes ont été condamnés à des peines de prison allant de 6 mois à 2 ans avec sursis seulement pour le viol de Shaina. Le parquet avait pourtant requis des peines de prison ferme. 

Le frère de Shaïna, @moicestyasin, a déploré que la qualification… https://twitter.com/NemesisNemesi75/status/1664255696492191744/photo/1",829,1356,155,2340
1049,1664203225841500166,2023-06-01 09:32:23,NemesisNemesi75,"🛑Agressions sexuelles dans les transports en commun🛑
Notre porte-parole @CordierAlice2 a été invitée sur @CNEWS pour parler de la tendance du « Subway shirt » qui consiste pour les femmes à porter un t-shirt large pour éviter les agressions ou le harcèlement sexuel.

« Depuis… https://twitter.com/NemesisNemesi75/status/1664203225841500166/video/1",91,223,17,331
1050,1663929595479851011,2023-05-31 15:25:04,NemesisNemesi75,@CordierAlice2 @TAXISG7 Que va t-il vraiment se passer @TAXISG7 pour ce chauffeur qui n’est absolument pas professionnel ?,7,69,3,79
1051,1663773770430001152,2023-05-31 05:05:52,NemesisNemesi75,"Nantes : 3 adolescentes de 15 ans agressées sexuellement dans le centre ville par une dizaine d’hommes près de la place du Commerce en sortant d’un kebab.

Les policiers n’ont pu identifier qu’un seul agresseur: un homme de 18 ans, sans domicile connu. Il a été placé en garde à…",186,362,17,565
1052,1663763387375841288,2023-05-31 04:24:37,NemesisNemesi75,"🛑TÉMOIGNAGE🛑Cette semaine nous retrouvons notre porte-parole Mathilda qui nous raconte sa vie en tant que femme à Lyon, dans le quartier de la Guillotière.

Si toi aussi tu veux témoigner et ne plus avoir peur d’identifier tes agresseurs, contacte-nous à l’adresse :… https://twitter.com/NemesisNemesi75/status/1663763387375841288/video/1",254,508,25,787
1053,1663762372480122880,2023-05-31 04:20:35,NemesisNemesi75,"Le rugbyman Mohamed Haouas condamné à 1 an de prison ferme sans mandat de dépôt par le tribunal correctionnel de Montpellier pour violences conjugales.

Selon son avocat, il a été pris d'«une crise de jalousie» et avait infligé à son épouse une balayette et une gifle, avant de la… https://twitter.com/NemesisNemesi75/status/1663762372480122880/photo/1",48,149,45,242
1054,1663459959705686017,2023-05-30 08:18:54,NemesisNemesi75,"Montpellier: une femme de 75 ans  a été “poignardée au cou » sur le parking de sa résidence. 

https://www.francebleu.fr/infos/faits-divers-justice/une-femme-retrouvee-morte-poignardee-au-cou-sur-un-parking-de-montpellier-7541870",92,138,9,239
1055,1663432374229639168,2023-05-30 06:29:17,NemesisNemesi75,https://www.leparisien.fr/amp/faits-divers/paris-un-homme-interpelle-pour-un-viol-dans-un-club-echangiste-28-05-2023-SD4VEUXJUVAO7IUHNRILJEHNXM.php,4,11,0,15
1056,1662405571209838594,2023-05-27 10:29:08,NemesisNemesi75,"Le ministre de l'Intérieur Gérarld Darmanin a annoncé le lancement d'une «grande opération pour la sécurité des femmes»: à partir du 30 mai et tout au long de l'été, ce seront cinq millions de flyers qui seront distribués par les policiers et les gendarmes.

Le but est donc… https://twitter.com/NemesisNemesi75/status/1662405571209838594/photo/1",50,128,27,205
1057,1662317347573583873,2023-05-27 04:38:34,NemesisNemesi75,"La petite Eya a été retrouvée au Danemark. Khaled Sassi (son père) et son complice soupçonnés d'avoir enlevé la jeune fille ont été interpellé.

 https://www.huffingtonpost.fr/faits-divers/article/eya-retrouvee-au-danemark-son-pere-et-le-complice-interpelles_218387.html",7,23,5,35
1058,1661975889805037570,2023-05-26 06:01:44,NemesisNemesi75,"➡️87% des femmes ont déjà été harcelées dans les transports en commun. C'est le résultat d'une étude de la Fédération nationale des usagers des transports publics.

➡️34% sont des atteintes sexuelles avec contact (viols et tentatives de viols, attouchements sexuels...)
 
➡️34%… https://twitter.com/NemesisNemesi75/status/1661975889805037570/photo/1",27,59,5,91
1059,1661970081771913217,2023-05-26 05:38:40,NemesisNemesi75,"20 ans de prison pour Louis Michel Manu (67 ans) pour avoir tué sa femme d’une balle dans la tête parce qu’elle souhaitait divorcer, il avait tenté de se suicider, sans succès.

https://m.20minutes.fr/amp/a/4038379",4,35,1,40
1060,1661968646116200448,2023-05-26 05:32:57,NemesisNemesi75,"« Je disais à ma fille, tu n’es pas dans n’importe quel pays. Tu es en France, dans le pays des droits de l’homme. Tu es protégée et il ne peut pas te tuer. J’étais déçu, très déçu » explique Kamel, le père de Chahinez Daoud, tuée par balle et immolée par son ex-conjoint Mounir…",236,612,31,879
1061,1661961076714373120,2023-05-26 05:02:53,NemesisNemesi75,"Said K., un Tunisien de 36 ans s’est suicidé à la prison de Fresnes. Il etait le principal suspect de la mort de sa femme peu avant Noël. Le trentenaire avait pris la fuite avec ses enfants et avait été recherché par la police. 

Après plusieurs semaines de cavale il avait…",21,78,11,110
1062,1661821623928758347,2023-05-25 19:48:44,NemesisNemesi75,"« J’ai dit à un type d’arrêter d’agresser une femme, c’est une interaction qui a duré trente secondes. Je me suis quasiment fait tuer pour ça. »

@jhirel , journaliste au @Le_Figaro a été gravement blessé en 2017 pour avoir défendu une femme dans le métro, qui venait de se faire… https://twitter.com/NemesisNemesi75/status/1661821623928758347/photo/1",239,560,14,813
1063,1661623825509826560,2023-05-25 06:42:46,NemesisNemesi75,"Les militantes Rémoises du Collectif Némésis ont rendu hommage à Carène Mézino au CHU de Reims où cette infirmière travaillait.

Elle a été poignardée à mort par un homme de 59 ans qui avait déjà poignardé quatre employés de l'ESAT de Le Meix-Tiercelin en 2017. 

Dans cette… https://twitter.com/NemesisNemesi75/status/1661623825509826560/photo/1",53,171,3,227
1064,1661066293221507082,2023-05-23 17:47:20,NemesisNemesi75,Alors celle-là c’est la meilleure de l’année « DamienRieu: Donc l’association @Utopia_56 qui occupe ILLÉGALEMENT une école pour y loger des clandestins ILLÉGAUX et faux mineurs ose pleurnicher et en appeler à la LOI  ? 😂 https://twitter.com/DamienRieu/status/1661061702555779094/photo/1 — https://twitter.com/damienrieu/status/1661061702555779094 »,178,783,27,988
1065,1660900045917396992,2023-05-23 06:46:43,NemesisNemesi75,"⚠️RAPPEL : 

Le nombre de victimes de violences conjugales signalées connaît une augmentation quasi-constante, comme le révèle les chiffres relayés par les co-rapporteures, passant de 152.981 en 2019 à 207.600 en 2021. 

Ces violences ayant provoqué 125 décès en 2020 (102 femmes…",1,8,0,9
1066,1660896015921336320,2023-05-23 06:30:42,NemesisNemesi75,"Lutte contre les violences intrafamiliales : un rapport parlementaire formule 59 propositions.

https://lcp.fr/actualites/lutte-contre-les-violences-intrafamiliales-un-rapport-parlementaire-formule-59",11,26,1,38
1067,1660579520821313536,2023-05-22 09:33:04,NemesisNemesi75,Notons quand même que notre ministre de la justice @E_DupondM nous confirme dans la reportage être totalement impuissant concernant les OQTF. Ils sont incapables de faire appliquer la loi.,48,179,2,229
1068,1660578704685137920,2023-05-22 09:29:49,NemesisNemesi75,"Reportage «La fabrique du mensonge
Affaire #Lola, chronique d'une récupération», #France5 n’a fait intervenir AUCUN contradicteur. Ce qui nous montre leur vision de la déontologie journalistique. 

#France5 fustige la récupération politique alors que le sujet du reportage est…",401,1012,19,1432
1069,1660351875428896769,2023-05-21 18:28:29,NemesisNemesi75,"Nos amis de l’@InstitutILIADE subissent actuellement la répression de Darmanin qui entraîne des frais imprévus. Il est important de soutenir cette organisation sérieuse et de qualité.

Vous pouvez le faire ici :

https://dons.institut-iliade.com « InstitutILIADE: 🔴 C'est maintenant que l'Institut Iliade a besoin de votre soutien financier !  

Dans une interdiction arbitraire et liberticide, l'hommage à Dominique Venner annulé par la préfecture de police sur ordre de Gérald Darmanin met l'Institut Iliade dans de graves difficultés.… https://twitter.com/InstitutILIADE/status/1660316172284313601/photo/1 — https://twitter.com/institutiliade/status/1660316172284313601 »",81,136,1,218
1070,1660285959198371842,2023-05-21 14:06:33,NemesisNemesi75,"Si vous souhaitez nous aider, vous pouvez nous faire un don sur Paypal à l’adresse collectif.nemesis@outlook.fr ou en suivant ce lien : 

https://www.paypal.com/donate/?cmd=_s-xclick&hosted_button_id=3YKTNP3ARC5CJ&source=url

➡️N'oubliez pas de vous abonner à notre chaine Youtube Nemesis Paris où vous retrouverez toutes nos vidéos et…",11,45,0,56
1071,1660285951803904001,2023-05-21 14:06:32,NemesisNemesi75,"🛑""J'ai une petite fille de 11 ans, je suis inquiète "" .

➡️Cette semaine nous sommes allées à la rencontre des habitants de la petite commune de Saint-Jean-Le-Vieux. 

Ses habitants sont inquiets de l'arrivée prochaine de migrants qui seront logés à la demande de l’État par… https://twitter.com/NemesisNemesi75/status/1660285951803904001/video/1",704,1292,117,2113
1072,1660260767529148418,2023-05-21 12:26:27,NemesisNemesi75,"Toulouse: une femme a été  agressée au couteau dans le métro. Un homme en état d’ivresse ayant été éconduit est a l’origine de l’agression, il a été maîtrisé et sorti de la rame par les autres passagers

https://www.francebleu.fr/infos/faits-divers-justice/un-homme-agresse-une-femme-au-couteau-dans-le-metro-il-est-ejecte-a-quai-par-les-passagers-1797080",35,96,1,132
1073,1660233945152122881,2023-05-21 10:39:52,NemesisNemesi75,"@GrablyR @CordierAlice2 @DamienRieu Quand France 5 titre le reportage « Affaire Lola, chronique d'une récupération » plutôt que «Affaire Lola, chronique d'un massacre qui aurait pu être évité » il est assez clair que le sujet principal du reportage sera « l’extrême droite » et pas le problème de fond qui est la non…",13,58,0,71
1074,1660210233325637634,2023-05-21 09:05:39,NemesisNemesi75,"🛑Disparition de Karine Esquivillon-Pialle: Adélaïde, la sœur de la mère de famille disparue remet en cause la version de l'époux : https://twitter.com/NemesisNemesi75/status/1660210233325637634/video/1",10,29,0,39
1075,1660031812817526786,2023-05-20 21:16:40,NemesisNemesi75,Réponse 2 : https://twitter.com/NemesisNemesi75/status/1660031812817526786/photo/1,7,53,2,62
1076,1660031806232489985,2023-05-20 21:16:39,NemesisNemesi75,Réponse 1 : https://twitter.com/NemesisNemesi75/status/1660031806232489985/photo/1,7,34,1,42
1077,1660031794773721089,2023-05-20 21:16:36,NemesisNemesi75,"Devinez comment s’appelle le chauffeur Bolt en question ? Devinez aussi l’origine de ceux qui disent à la victime qu’elle a mérité ce traitement puisqu’elle ose sortir seule le soir sans son mari imaginaire? 🙃 « Islamatou: Hier en rentrant de mon anniversaire à 2h, le chauffeur Bolt a décidé de m’offrir un verre. J’ai refusé à plusieurs reprises, montré ma bague, dit que mon mari avait ma localisation et m’attendait. Il s’est quand même arrêté à 3 bars (fermés) et a fini par acheter de la vodka — https://twitter.com/islamatou/status/1659258073876242447 »",78,370,10,458
1078,1659449436475367426,2023-05-19 06:42:31,NemesisNemesi75,"Pour #Cannes, nous aussi nous avons notre sélection catégorie science-fiction. Merci à @Francetele . https://twitter.com/NemesisNemesi75/status/1659449436475367426/video/1",42,198,16,256
1079,1659447655997530114,2023-05-19 06:35:26,NemesisNemesi75,https://www.radiofrance.fr/franceinter/trois-ans-de-prison-requis-contre-tariq-ramadan-dieudonne-temoin-de-moralite-8316822,2,22,1,25
1080,1659447653803982855,2023-05-19 06:35:26,NemesisNemesi75,"[PROCES TARIQ RAMADAN] : Trois ans de prison requis contre l’islamologue. Les échanges de messages entre l’accusé et la victime ont démontré que la victime était bien venue pour un échange intellectuel. 

Quand elle arrive à l'hôtel ""Mon repos"", après un dernier message à 22h49,…",37,118,9,164
1081,1659443938204237824,2023-05-19 06:20:40,NemesisNemesi75,"Gilbert Cuzou, ancien élu socialiste et ex-membre de l’équipe de campagne de Benoît Hamon pour 2017 condamné à un an de prison ferme pour harcèlement sexuel ainsi qu’une agression sexuelle. 

La partie ferme de la peine pourra être accomplie sous bracelet électronique, a précisé… https://twitter.com/NemesisNemesi75/status/1659443938204237824/photo/1",24,41,1,66
1082,1659178318598471681,2023-05-18 12:45:11,NemesisNemesi75,"Nîmes : Deux hommes ont été interpellés après avoir poursuivi et menacé trois  jeunes femmes pour obtenir leurs numéro de téléphone. L’un des agresseurs, armé d’un couteau et en état d’ivresse, a mordu un des policiers lors de l’arrestation. 

https://www.20minutes.fr/faits_divers/4028859-20230321-nimes-homme-ivre-soupconne-avoir-poursuivi-passantes-mordu-policier",132,178,6,316
1083,1659173806903111681,2023-05-18 12:27:16,NemesisNemesi75,"Esclavage sexuel : une jeune femme anglaise de 18 ans a été piégée et  contrainte de se prostituer pour le compte de trois proxénètes en Seine-Saint-Denis.
La victime souffrait de malnutrition, d’infections en plus des violences et des multiples viols. 

https://www.leparisien.fr/faits-divers/proxenetisme-de-la-grande-bretagne-aux-caves-de-cites-le-calvaire-delizabeth-18-ans-prostituee-de-force-16-05-2023-LSG5WF6YZVBADEQMFCXMOATWTE.php",90,127,13,230
1084,1659172296852922372,2023-05-18 12:21:16,NemesisNemesi75,"Une octogénaire a été victime d’une tentative de viol en plein centre-ville à Quimper, des témoins ont immobilisé l’agresseur en attendant la police. Celui-ci était déjà connu de services de police pour des faits de même nature. 

https://actu17.fr/faits-divers/quimper-un-homme-tente-de-violer-une-octogenaire-dans-la-rue-des-temoins-le-maitrisent.html",196,325,16,537
1085,1658389640611504128,2023-05-16 08:31:16,NemesisNemesi75,"[PROCÈS DE TARIQ RAMADAN] : Depuis hier, l’islamologue est jugé pour viol en Suisse. Tariq Ramadan se présente comme victime d’un « traquenard ». Il évoque un « piège », exploité par ses « ennemis idéologiques » pour lui nuire. 

https://www.lemonde.fr/societe/article/2023/05/16/au-premier-jour-de-son-proces-pour-viol-tariq-ramadan-se-pose-en-victime_6173525_3224.html",22,48,8,78
1086,1658073530569818114,2023-05-15 11:35:09,NemesisNemesi75,"En Suisse, une femmes s’est vidée de
son sang et en est morte. Son compagnon est suspecté d'avoir infligé ces violences gynécologiques avec son poing ou un objet. https://amp.20min.ch/fr/story/une-femme-decede-des-suites-de-violences-sexuelles-985904174619",60,107,14,181
1087,1657731886561591299,2023-05-14 12:57:35,NemesisNemesi75,"🟥TÉMOIGNAGE : Cette semaine nous retrouvons @JLechanteux , député Rassemblement National, qui a également été adjointe au maire de @david_rachline à Fréjus. Elle nous raconte son expérience à ce poste.    

➡️Si vous souhaitez nous aider, vous pouvez nous faire un don sur Paypal… https://twitter.com/NemesisNemesi75/status/1657731886561591299/video/1",25,85,4,114
1088,1657451616650383362,2023-05-13 18:23:54,NemesisNemesi75,"C’est complètement fou  que ces individus aient des couteaux sur eux en toute occasion. 

Et c’est certainement pas pour couper du saucisson …",23,219,15,257
1089,1657449056019312642,2023-05-13 18:13:43,NemesisNemesi75,Palais de l’injustice de #Lyon https://twitter.com/NemesisNemesi75/status/1657449056019312642/photo/1,73,303,7,383
1090,1657449048826150912,2023-05-13 18:13:41,NemesisNemesi75,Les affiches « problématiques»  en question : https://twitter.com/NemesisNemesi75/status/1657449048826150912/photo/1,74,275,4,353
1091,1657448627436937218,2023-05-13 18:12:01,NemesisNemesi75,"🛑DES MILITANTES DU COLLECTIF NEMESIS MENACÉES À LYON 🛑

Les militantes du Collectif Némésis ont réalisé ce matin devant le Palais de justice de Lyon une installation visant à dénoncer le laxisme judiciaire et migratoire. OQTF non appliquées, interdictions judiciaires non… https://twitter.com/NemesisNemesi75/status/1657448627436937218/video/1",444,930,65,1439
1092,1657011037785272322,2023-05-12 13:13:11,NemesisNemesi75,"Évidemment, rien ne nous assure que Jaouad Fellouk sera enfin expulsé après ses 3 ans de prison, ni même si il ira faire un tour en prison réellement.",11,82,2,95
1093,1657007308075855875,2023-05-12 12:58:22,NemesisNemesi75,"Jaouad Fellouk, demandeur d’asile depuis 29 ans en France et sous le coup d’une OQTF, écope de 3 ans de prison pour l’énième agression dégradante sur sa femme.

En plus des innombrables coups infligés synonymes de 45 jours d’ITT, le  prévenu a obligé sa concubine à faire ses…",182,302,14,498
1094,1656963546704490503,2023-05-12 10:04:29,NemesisNemesi75,"Le 31 mars dernier, au tribunal de grande instance de Bobigny (Seine-Saint-Denis), une femme victime de violences conjugales visiblement mécontente de la condamnation prise contre son conjoint, a balancé une chaussure sur la procureure de la République et l’a insultée. 

Une…",19,47,5,71
1095,1656959762175774720,2023-05-12 09:49:26,NemesisNemesi75,"Angers: détention prolongé d’un clandestin de 30 ans sous OQTF,  suspecté d’avoir violé une femme de 21 ans, en pleine rue, près du boulevard Foch, en mai 2022.

https://www.ouest-france.fr/pays-de-la-loire/angers-49000/vous-navez-aucune-empathie-suspecte-dun-viol-a-angers-il-restera-en-detention-7ee0cdae-ef3b-11ed-8f02-f38554d448ff",83,116,2,201
1096,1656587302049652738,2023-05-11 09:09:25,NemesisNemesi75,"Tommie Lindh avait 19 ans.

Militant contre l'immigration de masse qui touchait son pays, la Suède, son militantisme a vu tout son sens lorsqu'il est allé sauver cette jeune fille de 14 ans le 10 mai 2020, qui se faisait violer par un soudanais de 22 ans, multirécidiviste.… https://twitter.com/NemesisNemesi75/status/1656587302049652738/photo/1",846,2204,44,3094
1097,1656581297811103744,2023-05-11 08:45:33,NemesisNemesi75,https://www.leparisien.fr/amp/faits-divers/a-montauban-lincroyable-harcelement-dun-policier-sur-son-ex-10-05-2023-USKSY7MZSZESVKOUGNC7UYQPQI.php,7,31,0,38
1098,1656581296460529665,2023-05-11 08:45:33,NemesisNemesi75,"L’histoire est totalement abracadabrante, mais nous allons tenter de vous résumer ce cas de harcèlement totalement fou :

Julien B., un fonctionnaire de police mythomane et pervers est jugé pour harcèlement sur son ex-conjointe. 

Pour tenter de la récupérer, il avait organisé de…",33,175,15,223
1099,1656565919978606592,2023-05-11 07:44:27,NemesisNemesi75,"L’acteur Thierry Samitier (de la série «Nos chers voisins») placé en garde à vue pour agression sexuelle.

Selon la plainte, l’acteur aurait entre autres, embrassé de force ""avec la langue"" en pleine représentation sa partenaire de scène.

L’actrice explique n'avoir longtemps… https://twitter.com/NemesisNemesi75/status/1656565919978606592/photo/1",8,42,4,54
1100,1656564452680933377,2023-05-11 07:38:37,NemesisNemesi75,Le procès pour viol et de contrainte sexuelle commis avec cruauté de l’islamologue Tariq Ramadan s’ouvrira le 15 mai à Genève. https://twitter.com/NemesisNemesi75/status/1656564452680933377/photo/1,30,90,9,129
1101,1656562893981089792,2023-05-11 07:32:26,NemesisNemesi75,https://twitter.com/NemesisNemesi75/status/1656562893981089792/photo/1,3,22,1,26
1102,1656562499242606593,2023-05-11 07:30:51,NemesisNemesi75,"Le procès de Thomas Minery se poursuit en Dordogne. Accusé de viol sur une jeune mère de famille après s’être introduit à son domicile (et ce alors que les enfants de la victime étaient présents). Il encourt jusqu’à quinze ans de prison.

Le compagnon de la jeune mère de famille,… https://twitter.com/NemesisNemesi75/status/1656562499242606593/photo/1",64,231,22,317
1103,1656560498307891200,2023-05-11 07:22:54,NemesisNemesi75,"Mounir, un homme mis en examen en avril 2019 pour des accusations de viols sur 7 femmes est actuellement en liberté. Les avocats s'insurgent contre les délais de la justice, qualifiés de «violence institutionnelle». 

https://www.lefigaro.fr/faits-divers/j-ai-dit-cinq-fois-non-ca-a-ete-une-souffrance-atroce-a-angouleme-sept-jeunes-femmes-accusent-de-viol-un-meme-homme-20230509",103,143,6,252
1104,1656557986536366082,2023-05-11 07:12:56,NemesisNemesi75,https://www.lefigaro.fr/actualite-france/surpopulation-carcerale-la-controleuse-des-prisons-etrille-l-inertie-coupable-du-gouvernement-20230511,0,12,0,12
1105,1656557984271433729,2023-05-11 07:12:55,NemesisNemesi75,"Si vous vous demandez pourquoi trop souvent dans notre pays des personnes jugées coupables ressortaient libres du tribunal, voici l’une des raisons.

Un nouveau pic historique vient d'être atteint dans les prisons françaises avec 73.080 détenus au 1er avril pour 60.899 places. Un… https://twitter.com/NemesisNemesi75/status/1656557984271433729/photo/1",30,82,3,115
1106,1656415096472518656,2023-05-10 21:45:08,NemesisNemesi75,"Pourquoi ne pouvait-elle pas être maintenue le 12 mai, date retenue à l’origine ? Vous avez rétropédalé suite au tollé général et vous le savez très bien. « Sorbonne_Univ_: @NemesisNemesi75 @FBBlackler Bonjour @NemesisNemesi75, la conférence avec Florence Bergeaud-Blackler prévue ce vendredi n’a été ni censurée ni annulée mais reportée au vendredi 02 juin. — https://twitter.com/sorbonne_univ_/status/1656329244895596544 »",24,76,0,100
1107,1656325783533543424,2023-05-10 15:50:14,NemesisNemesi75,"La @Sorbonne_Univ_ se déshonore en annulant la conférence sur les Frères musulmans de @FBBlackler, spécialiste de l’islam. 

Jadis phare de la pensée française et du savoir, cette institution est devenue le summum de la lâcheté intellectuelle.",143,345,6,494
1108,1655969544341450755,2023-05-09 16:14:40,NemesisNemesi75,"Il y en a tellement que nous en oublions parfois : en mars dernier, Bechir Tabarki a été condamné à la reclusion à perpétuité pour l’assassinat de Jeanine Dessay, une infirmière à la retraite, dans les toilettes du Géant Casino de Pontarlier le 15 avril 2019. 

Toute sa vie… https://twitter.com/NemesisNemesi75/status/1655969544341450755/photo/1",87,136,0,223
1109,1655960707140136963,2023-05-09 15:39:33,NemesisNemesi75,"Autorisé à courir jusqu'au niveau départemental par la Fédération française d'athlétisme, Halba Diouf, athlète transgenre, a battu son record personnel sur 200 m (22''67) ce dimanche à Nice (tout près des minima pour les JO, 22''57) qui ferait de lui la ""neuvième meilleure…",10,49,2,61
1110,1655960703985934338,2023-05-09 15:39:32,NemesisNemesi75,"André Giraud, président de la FFA (Fédération française d’athlétisme explique : ""Homme, Halba Diouf était 980e coureur français ; femme, elle devenait 58e mondiale"". https://twitter.com/NemesisNemesi75/status/1655960703985934338/photo/1",74,176,21,271
1111,1655819537994883073,2023-05-09 06:18:36,NemesisNemesi75,"Bamdad Amin, un prédateur sexuel récidiviste est ressorti libre du tribunal malgré un lourd casier et sans aucun séjour en prison à son actif :

Le 5 janvier 2016, il est pourtant condamné, pour des faits d’agression sexuelle sur trois mineurs, victimes de ces agissements au… https://twitter.com/NemesisNemesi75/status/1655819537994883073/video/1",180,313,20,513
1112,1655592525803970563,2023-05-08 15:16:32,NemesisNemesi75,https://www.leprogres.fr/faits-divers-justice/2023/05/06/un-couple-agresse-au-couteau-dans-une-station-de-metro-l-auteur-maitrise-par-un-temoin,86,205,0,291
1113,1655592522842865666,2023-05-08 15:16:31,NemesisNemesi75,"À Lyon, un couple a été agressé à coups de couteau par un individu dans une station de métro. 

La raison ? L’individu en question ne supportait pas que la femme du couple sorte avec un homme EUROPÉEN. 

Cette agression est pour les médias de l’ordre du fait divers. Mais imaginez…",1005,2575,52,3632
1114,1655212610831228931,2023-05-07 14:06:53,NemesisNemesi75,"Si vous souhaitez nous aider, vous pouvez nous faire un don sur paypal à l’adresse collectif.nemesis@outlook.fr ou en suivant ce lien : https://www.paypal.com/donate/?cmd=_s-xclick&hosted_button_id=3YKTNP3ARC5CJ&source=url",7,30,2,39
1115,1655212604074213378,2023-05-07 14:06:51,NemesisNemesi75,"🛑 Trop française pour avoir accès à un logement social pour elle et son fils ? 

C’est ce qu’a vécu @JLechanteux en 2006 alors qu’elle était mère isolée. Ce genre d’injustice l’a fait s’engager au @RNational_off , parti dans lequel elle est désormais député. 

➡️Pour rappel en… https://twitter.com/NemesisNemesi75/status/1655212604074213378/video/1",475,1226,68,1769
1116,1654580279732842496,2023-05-05 20:14:13,NemesisNemesi75,"Strasbourg: Un ghanéen de 28 ans, a été condamné à 25 ans de prison pour le viol et l’assassinat de sa compagne Sandra Baumann.

https://france3-regions.francetvinfo.fr/grand-est/bas-rhin/strasbourg-0/feminicide-le-compagnon-de-sandra-baumann-condamne-a-25-ans-de-prison-pour-assassinat-et-viol-2766790.html",58,128,8,194
1117,1654145326859599872,2023-05-04 15:25:53,NemesisNemesi75,"En Alsace, Yassim Lamri, déjà connu pour des faits de violence condamné à 4 ans de prison ferme pour avoir roué de coups jusqu’à perdre connaissance un père de famille intervenu quand un « jeune» a insulté sa compagne. https://www.lalsace.fr/amp/faits-divers-justice/2023/05/03/quatre-ans-ferme-pour-avoir-roue-de-coups-un-homme-dans-un-parc",32,88,5,125
1118,1653683265381752833,2023-05-03 08:49:49,NemesisNemesi75,"Le corps retrouvé calciné à Dun-sur-Auron le 26 avril pourrait être celui de Corinne Picard, une femme de 55 ans. Son compagnon, un homme né en 1968 déjà bien connu de la justice pour « différents faits » a arrêté pour homicide volontaire sur conjoint.

https://www.leberry.fr/dun-sur-auron-18130/actualites/corps-retrouve-calcine-a-dun-sur-auron-l-occupant-de-la-maison-arrete-pour-homicide-volontaire-sur-conjoint_14303306/",23,55,0,78
1119,1653681298483953667,2023-05-03 08:42:00,NemesisNemesi75,"En mars dernier, l’Hannah Arensman avait annoncé mettre un terme à sa carrière à seulement 24 ans après avoir été devancée par Killips. Inga Thompson, qui a participé à trois JO et qui a été quintuple championne nationale de course sur route, a comparé la victoire de Kilips à…",12,78,5,95
1120,1653681296059641856,2023-05-03 08:41:59,NemesisNemesi75,"Austin Kilips, un homme, vient de remporter une importante course cycliste féminine. Ce coureur masculin pourrait prochainement participer au Tour de France féminin et aux JO 2024, malgré la fronde de plusieurs coureuses qui s'estiment lésées. https://twitter.com/NemesisNemesi75/status/1653681296059641856/photo/1",263,607,93,963
1121,1653676925640929281,2023-05-03 08:24:37,NemesisNemesi75,"Un adjudant-chef, sapeur-pompier professionnel, a été condamné par le tribunal de Vienne. Le 7 septembre 2022, dans une caserne nord-iséroise, il avait agressé sexuellement une jeune femme sapeur-pompier qu’il avait convoquée en raison d’un retard. 

https://www.ledauphine.com/faits-divers-justice/2023/05/03/agression-sexuelle-sur-une-jeune-pompier-un-adjudant-chef-condamne",17,41,0,58
1122,1653676051912851457,2023-05-03 08:21:09,NemesisNemesi75,"Le procès de Cyril Russo a débuté hier. Le sexagénaire a été condamné en juin 2022 à 14 ans de réclusion criminelle pour viol sur son épouse et tentative d’enlèvement. 

https://france3-regions.francetvinfo.fr/corse/justice-un-proces-en-appel-pour-viol-sur-conjoint-et-tentative-d-enlevement-debute-a-ajaccio-2764638.html",4,18,0,22
1123,1653426074250891266,2023-05-02 15:47:49,NemesisNemesi75,"Philippe Boomer parle d’un sujet qui ne le concerne pas et qu’il ne vivra jamais. 

Vos filles, elles, savent. Pourquoi vouloir leur préparer l’enfer ?",23,256,7,286
1124,1653386645117325313,2023-05-02 13:11:09,NemesisNemesi75,"Et ces pays où le voile est imposé ce sont lesquels 🙃? Et ces pays où le voile est interdit ce sont lesquels ? Vous mettez vraiment ces pays sur le même plan niveau droits des femmes @amnestyfrance ? Vraiment ? « AmnistieCA: Dites-le plus fort pour les personnes à l'arrière 📢 👀

Le port du voile ne devrait jamais être forcé ou interdit ✊ https://twitter.com/AmnistieCA/status/1652332052333592576/photo/1 — https://twitter.com/amnistieca/status/1652332052333592576 »",56,294,6,356
1125,1653130673597685760,2023-05-01 20:14:00,NemesisNemesi75,"@lelapindufutur On ne sait pas ce qui est le plus drôle et le plus pathétique : le fait que lui la connaisse alors qu’elle, elle ne le connaît pas ou cette attitude de serpillère pour bien se faire voir « eyh regardez moi je suis pas raciste hein, donnez moi un bon point »",9,254,7,270
1126,1653112066910085160,2023-05-01 19:00:04,NemesisNemesi75,Incroyable mais vrai 🥲 https://twitter.com/NemesisNemesi75/status/1653112066910085160/photo/1,206,1591,76,1873
1127,1653081827555397632,2023-05-01 16:59:55,NemesisNemesi75,@Antarctika4 Et donc le seul tweet que vous avez trouvé à faire à son sujet c’est de la traiter de facho parce qu’elle n’en peut plus d’être emmerdée dans sa ville natale ?,68,1187,15,1270
1128,1653038582053892096,2023-05-01 14:08:04,NemesisNemesi75,@calamityjanebb Il n’y a pas de militants masculins chez nous.,0,0,1,1
1129,1653038008617107458,2023-05-01 14:05:47,NemesisNemesi75,"@Margueritestern Merci pour ton honnêteté intellectuelle. Au Collectif Nemesis si nous avons tenu à nous revendiquer féministes c’est parce que le féminisme à la base était une bonne chose, nécessaire. 

Rien de plus normal pour nos aïeules que de vouloir être respectées. Force est de constater…",46,409,7,462
1130,1652738088106442752,2023-04-30 18:14:01,NemesisNemesi75,"Si toi aussi tu veux témoigner et ne plus avoir peur d’identifier tes agresseurs, contacte-nous à l’adresse : collectif.nemesis@outlook.fr

Si vous souhaitez nous aider, vous pouvez nous faire un don sur paypal à l’adresse collectif.nemesis@outlook.fr ou en suivant le lien en bio…",92,279,7,378
1131,1652738085514346496,2023-04-30 18:14:00,NemesisNemesi75,"🛑🎥Autrefois ville préférée des Français, Nantes est devenue un enfer. 

➡️Alice nous explique les raisons de cette dégradation. https://twitter.com/NemesisNemesi75/status/1652738085514346496/video/1",2662,6895,535,10092
1132,1651998734589341719,2023-04-28 17:16:05,NemesisNemesi75,"Montbéliard:  Mohamed Chalabi, 41 ans, s’est introduit dans un appartement familial et a agressé  sexuellement une jeune femme  de 22 ans. Il a été condamné à 2 ans de prison. 

https://www.estrepublicain.fr/faits-divers-justice/2023/04/25/il-penetre-dans-l-appartement-familial-en-pleine-nuit-et-agresse-sexuellement-une-jeune-femme#lh0tawlauk49r1olk9",167,203,24,394
1133,1651996955503996929,2023-04-28 17:09:01,NemesisNemesi75,"Oise: Un homme algérien, en situation irrégulière sur le territoire, a attaqué au verre brisée une  mariée en pleine noce, la blessant au bras et à la gorge, plusieurs invités ont été blessés également.  

https://actu.fr/hauts-de-france/pont-l-eveque_60506/la-mariee-blessee-a-la-gorge-par-un-invite-pendant-la-noce-dans-l-oise_59206115.html",303,435,25,763
1134,1651264554536517632,2023-04-26 16:38:43,NemesisNemesi75,"Ce matin, la mère de la petite fille de cinq ans, dont le corps sans vie a été découvert la veille à Rambervillers, a laissé éclater sa colère quant au fait que le suspect ait été remis en liberté : «Je veux que la justice soit faite et qu'on ne laisse plus les malades dehors,…",29,80,1,110
1135,1651264039828217858,2023-04-26 16:36:40,NemesisNemesi75,"Meurtre de Rose : le suspect déjà mis en examen pour viol sur mineur.

https://www.lefigaro.fr/faits-divers/meurtre-d-une-fillette-dans-les-vosges-le-suspect-etait-deja-mis-en-examen-pour-viol-sur-mineur-20230426",67,93,9,169
1136,1651175441930018816,2023-04-26 10:44:37,NemesisNemesi75,"Mardi, la petite Rose (5 ans) a été retrouvée morte dans un sac poubelle. 
Nous nous joignons à la douleur de sa famille et, peut-être aussi, à sa colère : 

comme trop souvent, la personne interpellée était déjà connu des services de police : ici, un adolescent de 16 ans déjà…",407,1067,56,1530
1137,1650790923561848832,2023-04-25 09:16:41,NemesisNemesi75,"Viol d’une femme de 98 ans : Jean-François A, un violeur récidiviste originaire de Guadeloupe interpellé. 

Il nie en bloc malgré la présence de son ADN. Ce jeune homme est déjà connu pour deux viols commis en 2018 et en 2020 dans la capitale.

https://www.leparisien.fr/amp/faits-divers/paris-le-suspect-du-viol-dune-nonagenaire-arrete-dans-le-xixe-arrondissement-24-04-2023-IG27777B55HQJFJ56IY7LHR2ZE.php",39,71,5,115
1138,1650789311023923200,2023-04-25 09:10:16,NemesisNemesi75,"Nous n’avons absolument jamais dit que les violences conjugales étaient le fait uniquement de certaines origines ou de la religion musulmane (nous partageons tous les faits, peu importe l’origine de l’agresseur ou de l’accusé).

Mais oui, il y a une sureprésentation des hommes… « sarahfrikh: Je n'apprécie que ce collectif 😱 reprenne l'affaire de ma lionne!
Juste Cynthia est maghrébine et la violence et les Féminicides touchent toutes les communautés, origines et religion....donc c'est pas la peine d'essayer l'amalgame merci! — https://twitter.com/sarahfrikh/status/1650786018054873088 »",44,238,4,286
1139,1650786707715891200,2023-04-25 08:59:55,NemesisNemesi75,"Ahmed Khalef, un Algérien de 35 ans en situation irrégulière, jugé depuis le 24 avril par la cour d’assises de Gironde pour viol sous la menace d’une arme. 

Pour justifier son acte, il a dit lors de son procès qu’il pensait que la victime était une prostituée et qu’il était… https://twitter.com/NemesisNemesi75/status/1650786707715891200/photo/1",350,645,58,1053
1140,1650782310688604160,2023-04-25 08:42:27,NemesisNemesi75,"« Sale petite p*te que tu es va, la Mecque si je te charcle pas ».

Le 11 mars dernier, Cynthia a été violemment agressée à coups de cutter dans son quartier à Vénissieux par son ex-petit ami à qui elle avait annoncé sa volonté de se séparer.

40 points de suture, au total 60… https://twitter.com/NemesisNemesi75/status/1650782310688604160/photo/1",766,1263,271,2300
1141,1650478000930971648,2023-04-24 12:33:14,NemesisNemesi75,".@Utopia_56, pourriez-vous dire à votre bénévole d’arrêter de nous harceler et de nous insulter svp ?  Benevole qui a confirmé d’ailleurs être venu pour apporter de la nourriture aux migrants qui pratiquaient le ramadan samedi soir à 21h https://twitter.com/NemesisNemesi75/status/1650478000930971648/photo/1",53,221,8,282
1142,1650429151675928576,2023-04-24 09:19:07,NemesisNemesi75,"Paris : ses monuments, sa gastronomie, sa mode 🙃 https://twitter.com/NemesisNemesi75/status/1650429151675928576/photo/1",107,355,7,469
1143,1650124936684421123,2023-04-23 13:10:17,NemesisNemesi75,".@sandrousseau se réjouit donc qu’une femme contrôleuse n’ait pas été respectée par des hommes. Cocasse pour une féministe. 🙃

Par contre, vous ne verrez jamais @sandrousseau avoir un mot pour cette contrôleuse agressée par un Syrien :

https://www.laprovence.com/actu/en-direct/6629802/avignon-sans-papiers-sans-billet-et-sans-masque-dans-le-tgv-il-agresse-les-controleuses.html « sandrousseau: Gloire à cette contrôleuse ! — https://twitter.com/sandrousseau/status/1649881199001624578 »",189,764,18,971
1144,1649822433141047296,2023-04-22 17:08:14,NemesisNemesi75,"L’effondrement du niveau scolaire, notamment en maths, est tel que beaucoup de gens aujourd’hui sont incapables de comprendre les concepts de la proportionnalité (et donc de la surreprésentation) « strmlb: @DamienRieu si je calcule bien, 59% des cambriolages sont donc commis par des personnes non étrangères

donc ne vous plaignez pas des cambriolages si vous défendez [vous défendez quoi d'ailleurs Damien Rieu? mdr, non mais vraie question] — https://twitter.com/strmlb/status/1649785010877022209 »",96,473,6,575
1145,1649803559586746368,2023-04-22 15:53:15,NemesisNemesi75,Merci à @Valeurs pour cette info. https://www.valeursactuelles.com/politique/info-va-41-des-mis-en-cause-pour-cambriolages-sont-etrangers-35-pour-vols-violents-sans-arme,4,29,0,33
1146,1649803556415762434,2023-04-22 15:53:14,NemesisNemesi75,"À l’échelle nationale, 41% des mis en cause pour cambriolages sont de nationalité étrangère, 35% pour vols violents sans arme, 17% pour coups et blessures volontaires, 13% pour violences sexuelles et 17% pour homicides. Des chiffres qui illustrent la surreprésentation des… https://twitter.com/NemesisNemesi75/status/1649803556415762434/photo/1",112,279,14,405
1147,1649753263539998720,2023-04-22 12:33:23,NemesisNemesi75,Chloé (20 ans) a été retrouvée ! https://www.huffingtonpost.fr/faits-divers/article/chloe-la-joggeuse-disparue-a-dammartin-en-goele-retrouvee-apres-une-fugue_216963.html,8,52,8,68
1148,1649736488010014722,2023-04-22 11:26:44,NemesisNemesi75,"Sauvons les écureuils roux !@sandrousseau @CaronAymericoff « Vertumne1: Guerre des écureuils en 🇬🇧 : le gris exotique remplace le roux autochtone. 

Porteur de maladies, mieux adapté au milieu urbain, plus massif et plus fertile que le roux, le gris est en passe d'éradiquer l'espèce locale. https://twitter.com/Vertumne1/status/1591837323133878273/photo/1 — https://twitter.com/vertumne1/status/1591837323133878273 »",21,85,3,109
1149,1649690682888540160,2023-04-22 08:24:43,NemesisNemesi75,https://twitter.com/NemesisNemesi75/status/1649690682888540160/video/1,4,12,0,16
1150,1649689505840898051,2023-04-22 08:20:02,NemesisNemesi75,Garges-les-Gonesses et Saint Denis 2023 … et bientôt toute la France si nous n’agissons pas : https://twitter.com/NemesisNemesi75/status/1649689505840898051/video/1,218,393,38,649
1151,1649676157048987654,2023-04-22 07:26:59,NemesisNemesi75,"Argenteuil : une femme poignardée à mort, son compagnon interpellé.

https://www.leparisien.fr/amp/faits-divers/val-doise-une-femme-poignardee-a-mort-son-compagnon-interpelle-21-04-2023-4AMK3UACYBE5JCG2KVPAQP64YQ.php",10,22,0,32
1152,1649673910193987586,2023-04-22 07:18:04,NemesisNemesi75,"Seine-et-Marne : disparition inquiétante de Chloé, une joggeuse de 20 ans.

La gendarmerie a diffusé un appel à témoins pour disparition inquiétante. Le jour où Chloé a été vue pour la dernière fois, elle portait une doudoune noire sans manches, un sweat bleu, un jogging noir et… https://twitter.com/NemesisNemesi75/status/1649673910193987586/photo/1",140,149,7,296
1153,1649673275503521794,2023-04-22 07:15:32,NemesisNemesi75,http://actu.fr/normandie/bois-guillaume_76108/deux-morts-a-bois-guillaume-la-femme-a-ete-poignardee_58724671.html,10,36,0,46
1154,1649673274169647106,2023-04-22 07:15:32,NemesisNemesi75,"Encore une fois, si l’obligation de quitter le territoire français avait été respectée, la vie d’une femme aurait pu être épargnée : 

Samedi 1er avril à Bois-Guillaume près de Rouen, Yamina (47 ans) a été mortellement poignardée par son compagnon, déjà connu de la justice et…",204,483,4,691
1155,1649449137333567496,2023-04-21 16:24:54,NemesisNemesi75,"Le docteur Daniel M’Bey, cardiologue à l’hôpital de Pontivy, est jugé pour un viol et 2 agressions sexuelles sur ses patientes. Il attaquait ses victimes par soumission chimique. 

https://www.letelegramme.fr/bretagne/un-cardiologue-juge-pour-viol-et-agressions-sexuelles-devant-les-assises-du-morbihan-03-04-2023-13310534.php",28,60,3,91
1156,1649346000107044866,2023-04-21 09:35:04,NemesisNemesi75,"« Dans la structure que j’encadre, en 2022, 100% des personnes sorties pour attouchements sexuels non-désirés sont des personnes d’origine maghrébine ». explique @le_jarl dans sa video pour répondre à Sos Racisme. 

Il explique que cela représente 28 personnes sur l’année 2022. https://twitter.com/NemesisNemesi75/status/1649346000107044866/video/1",639,1276,49,1964
1157,1649337259206889473,2023-04-21 09:00:20,NemesisNemesi75,Le journaliste sportif Pierre Ménès écope de deux mois de prison avec sursis de la part du Tribunal correctionnel de Paris pour des agressions sexuelles sur 3 femmes. https://www.midilibre.fr/2023/04/19/accuse-dagressions-sexuelles-pierre-menes-condamne-a-deux-mois-de-prison-avec-sursis-11144313.php,5,20,4,29
1158,1649336431897198592,2023-04-21 08:57:03,NemesisNemesi75,"La star marocaine Saad Lamjarred , condamnée à 6 ans pour viol en première instance, vient d’être remise en liberté avant son procès en appel. https://www.leparisien.fr/amp/faits-divers/accuse-de-viol-le-chanteur-saad-lamjarred-remis-en-liberte-avant-son-proces-en-appel-21-04-2023-GYWFEB5XTNEJNDQJPTCLS2V2ZQ.php",30,45,0,75
1159,1649335453311553536,2023-04-21 08:53:09,NemesisNemesi75,"À Toulouse, une bande retient et terrorise deux jeunes filles dans un appartement qu’ils ont dépouillées sous la menace d’un cutter. Les suspects, âgés de 15 à 26 ans, sont toujours en garde à vue ce mardi pour « extorsion aggravée en réunion ». https://m.20minutes.fr/amp/a/4033235",84,156,6,246
1160,1649334190498803713,2023-04-21 08:48:08,NemesisNemesi75,"Les protégés de l’association @Utopia_56 ont encore frappé : Hamza et Mohamed, migrants marocain et libyen, volent les effets d’une petite fille qui allait être hospitalisée. https://www.leprogres.fr/faits-divers-justice/2023/04/18/sans-le-savoir-les-voleurs-ciblent-la-voiture-d-une-petite-patiente-du-centre-leon-berard",254,426,12,692
1161,1649103479393206284,2023-04-20 17:31:23,NemesisNemesi75,"Si n’importe quelle femme de gauche avait été traitée de pute, @sandrousseau aurait bondi. Mais comme d’habitude, son féminisme est à deux vitesses… « sandrousseau: Quelque part dans #Paris, 300 jeunes, mineurs isolés, sont hébergés dans une école désaffectée. Les conditions de vie sont indécentes. Des groupes d’extrême-droite viennent régulièrement les menacer.
Ils doivent être pris en charge @Prefet75_IDF. https://twitter.com/sandrousseau/status/1649091334588993536/photo/1 — https://twitter.com/sandrousseau/status/1649091334588993536 »",78,372,16,466
1162,1649101864154157057,2023-04-20 17:24:57,NemesisNemesi75,@sandrousseau @Prefet75_IDF Un commentaire @sandrousseau en tant que féministe sur les insultes sexistes de vos amis ?  Quelle blague ! Les seuls à avoir menacer de nous «baiser » de nous «niquer notre race » et nous ont traités traiter de « salez putes » sont les bénévoles d’@Utopia_56 .,54,383,5,442
1163,1649051709615001602,2023-04-20 14:05:40,NemesisNemesi75,@Margueritestern @DamienRieu Selon le ministère de l'Intérieur en 2020 14% de personnes de nationalité étrangère parmi les mis en cause dans des affaires de violences sexuelles. La note du ministère elle-même indique que les personnes étrangères sont surreprésentées (parmi les victimes aussi d’ailleurs) https://twitter.com/NemesisNemesi75/status/1649051709615001602/photo/1,1,13,1,15
1164,1649043445011415041,2023-04-20 13:32:49,NemesisNemesi75,".@Utopia_56 , en 24h vous êtes passés de « c’est le Collectif Némésis qui est venu harceler nos bénévoles mais les insultes émises à leur encontre ne sont pas représentatives des valeurs de notre association » à : «C’est pas nous» 🙃. Personne n’est dupe.",10,63,2,75
1165,1649041073145106432,2023-04-20 13:23:24,NemesisNemesi75,@Utopia_56 @Margueritestern Bah oui bien sur 🤡. Des bénévoles d’Utopia attendaient cette voiture et ils leurs ont ouvert le portail (portails qui sont d’ailleurs cadenassés par votre asso) C’était qui alors ? Des migrants ? Les dealers peut-être ? 🙃,2,85,0,87
1166,1649039491879895040,2023-04-20 13:17:07,NemesisNemesi75,"Bah oui bien sur 🤡. Des bénévoles d’Utopia attendaient cette voiture et ils leurs ont ouvert le portail (portails qui qui sont d’ailleurs cadenassés par votre asso) C’était qui alors ? Des migrants ? Les dealers peut-être ? 🙃 « Utopia_56: @Margueritestern @NemesisNemesi75 1. La nature de l’insulte est insupportable
2. La personne à l’origine n’est pas un bénévole d’Utopia 56 — https://twitter.com/utopia_56/status/1649002644407558150 »",46,171,5,222
1167,1648991698096193538,2023-04-20 10:07:12,NemesisNemesi75,"@Margueritestern @DamienRieu Oui, voici le lien pour l’étude de l’INSEE : https://www.insee.fr/fr/statistiques/3633212 https://twitter.com/NemesisNemesi75/status/1648991698096193538/photo/1",1,6,1,8
1168,1648990648379363329,2023-04-20 10:03:01,NemesisNemesi75,"@Margueritestern @DamienRieu Et bien sur dans les 86% d’auteurs « français » on parle de nationalité seulement, pas de leur ethnie.",0,7,1,8
1169,1648990484017082370,2023-04-20 10:02:22,NemesisNemesi75,"@Margueritestern @DamienRieu Pour répondre à cette question : en 2021, 14% des auteurs  de morts violentes au sein du couple étaient étrangers (2 ressortissants UE et 18 hors UE). Selon l’Insee les étrangers représentent 7,7% de la pop. Ils sont donc 2x plus représentés que les français.",10,31,2,43
1170,1648973698915790848,2023-04-20 08:55:40,NemesisNemesi75,"@Margueritestern Encore heureux qu’ils ne soient pas tous des agresseurs, on ne va pas donner une médaille à ceux qui ne font que respecter la loi. Mais la loi, elle va assurément changer quand les étrangers seront majoritaires, que l’islam sera la religion principale et la charia appliquée.",2,27,1,30
1171,1648972479874883584,2023-04-20 08:50:50,NemesisNemesi75,"@Margueritestern Nous sommes encore dans un pays majoritairement autochtone, c’est donc logique qu’il y ait plus de Jean-Pierre qui tuent leurs femmes que de Mohamed. Évidemment, l’idéal serait que Jean-Pierre arrête de tuer sa femme et Mohamed aussi et trouve le bonheur dans son pays d’origine.",3,16,1,20
1172,1648971012766064641,2023-04-20 08:45:00,NemesisNemesi75,"@Margueritestern Oui bien sûr, on partage aussi les agressions / viols / meurtres de femmes même s’ils sont commis par des blancs. Force est de constater qu’il y en aurait bcp moins si on s’épargnait l’immigration. Et c’est un fait, les hommes étrangers sont surreprésentés dans ces crimes.",6,17,0,23
1173,1648968579990028290,2023-04-20 08:35:20,NemesisNemesi75,"@Margueritestern Une petite partie d’entre eux seulement le sont. Dans tous les cas un monde sans hommes n’est ni possible, ni souhaitable. Par contre ce qui est possible et souhaitable c’est de ne pas importer plus de violeurs que nous en avons déjà. Je pense que nous serons d’accord là dessus.",1,18,1,20
1174,1648967998340751360,2023-04-20 08:33:01,NemesisNemesi75,@Margueritestern L’immense majorité des migrants qui arrivent en France sont des hommes (69% en 2015 selon les chiffres du Haut-Commissariat des Nations unies pour les réfugiés). Oui les agresseurs sont des hommes majoritairement mais tous les hommes ne sont pas des agresseurs.,2,19,2,23
1175,1648963849129738242,2023-04-20 08:16:32,NemesisNemesi75,"@Margueritestern Donc ces quartiers sont dangereux pour les femmes en très très grande partie à cause d’hommes issus de l’immigration, nous sommes d’accord là dessus. Mais tu ne penses pas que la politique d’immigration actuelle ne fait qu’aggraver le problème ?",4,30,6,40
1176,1648962203238711298,2023-04-20 08:10:00,NemesisNemesi75,"@Margueritestern Donc ces quartiers sont dangereux pour les femmes en très très grande partie à cause d’hommes issus de l’immigration, nous sommes d’accord là dessus. Mais tu ne penses pas que la politique d’immigration actuelle ne fait qu’aggraver le problème ?",2,7,0,9
1177,1648959764846583808,2023-04-20 08:00:18,NemesisNemesi75,"Merci pour ces encouragements ! Si vous souhaitez nous aider, et nous voir continuer le combat, vous pouvez le faire ici : https://tinyurl.com/m2b7zkjk  Notre adresse Paypal : collectif.nemesis@outlook.fr 💙

Nos convictions n’ont pas de prix mais le militantisme lui, a bien un coût… « DidierPfad: @NemesisNemesi75 En tout cas, @CordierAlice2 , vous et vos amies du Collectif vous êtes courageuses, au nombre d’insultes, d’agressions que vous subissez vous avez vraiment du cran.
Félicitations à vous toutes!
Je fais des dons occasionnels mais je crois que je vais en faire de manière mensuelle — https://twitter.com/didierpfad/status/1648905614901530624 »",29,74,1,104
1178,1648952127807533056,2023-04-20 07:29:57,NemesisNemesi75,@Margueritestern Bonjour @Margueritestern. As-tu continué ce bénévolat ? Si non : pourquoi ? N’est-ce vraiment la faute que des blancs en sarouel sincèrement ? Nous avons des militantes qui habitaient proche de la Chapelle Pajol et leurs récits sont bien différents malheureusement…,15,110,3,128
1179,1648751887770869768,2023-04-19 18:14:17,NemesisNemesi75,"Nous sommes certaines que les clients de ces différentes entreprises ne sont pas du tout au courant de leurs agissements.

Nous vous invitons à les boycotter et à les interpeller sur vos RS. Merci 💙",44,238,4,286
1180,1648751884046413824,2023-04-19 18:14:16,NemesisNemesi75,"Voici la liste des entreprises et assos qui financent @Utopia_56. 

À l’heure où 65% des Français veulent la fin de l’immigration, peut-on laisser des entreprises comme @nexity, @LeaNature , @agnesbofficiel ou @SwissLife_Fr financer des actions illégales et l’invasion migratoire? https://twitter.com/NemesisNemesi75/status/1648751884046413824/photo/1",266,507,30,803
1181,1648751874797961217,2023-04-19 18:14:13,NemesisNemesi75,"🛑🛑Samedi 15 avril, nos militantes ont été agressées par des bénévoles de l’association @Utopia_56. 

➡️Notre vidéo pour comprendre notre action et aussi ce qui se cache derrière l’association @Utopia_56 : 

https://youtu.be/IqKfuw-jnLo https://twitter.com/NemesisNemesi75/status/1648751874797961217/video/1",754,1373,77,2204
1182,1648588560587452416,2023-04-19 07:25:16,NemesisNemesi75,"Sans parler de Christine de Pizan qui était déjà une proto-féministe.

@NousToutesOrg , un mouvement censé défendre les femmes, en accuse certaines et les culpabilise en les dépossédant de leur histoire. C’est très grave. https://twitter.com/NemesisNemesi75/status/1648588560587452416/photo/1",14,76,3,93
1183,1648588553763299328,2023-04-19 07:25:15,NemesisNemesi75,"Petit rappel des faits : le féminisme est littéralement né en Europe occidentale. 
La première qui se revendiquera comme féministe est Hubertine Auclert qui s'est battue en faveur de l’éligibilité des femmes et de leur droit de vote. https://twitter.com/NemesisNemesi75/status/1648588553763299328/photo/1",14,82,1,97
1184,1648588546830135296,2023-04-19 07:25:13,NemesisNemesi75,Nous Toutes accuse les femmes blanches d’avoir tout volé aux femmes non-blanches. https://twitter.com/NemesisNemesi75/status/1648588546830135296/photo/1,11,51,2,64
1185,1648588539666243585,2023-04-19 07:25:11,NemesisNemesi75,⚠️[THREAD]⚠️L’association @NousToutesOrg en plein délire ethno-masochiste à deux doigts de demander aux femmes blanches de se flageller quotidiennement et de « s’auto-réguler ». Un terme totalitaire qui fait froid dans le dos : https://twitter.com/NemesisNemesi75/status/1648588539666243585/photo/1,139,369,29,537
1186,1648434363867222016,2023-04-18 21:12:33,NemesisNemesi75,"Nous avions oublié ce «détail» mais @Utopia_56 n’en n’est pas à son coup d’essai niveau non-respect des femmes. Ils demandent à leurs bénévoles de ne pas s’habiller en jupe , décolleté pour travailler au contact des migrants pour « respecter la différence culturelle »: https://twitter.com/NemesisNemesi75/status/1648434363867222016/photo/1",517,928,88,1533
1187,1648366489030762499,2023-04-18 16:42:50,NemesisNemesi75,https://twitter.com/NemesisNemesi75/status/1648366489030762499/video/1,11,22,1,34
1188,1648360851009683466,2023-04-18 16:20:26,NemesisNemesi75,"Nous n’avons harcelé PERSONNE nous avons simplement voulu faire un discours devant une banderole. Les seuls harceleurs sont vos bénévoles qui nous immédiatement insultés. Les vidéos parlent d’elles-mêmes, nous sommes calmes et vous êtes hystériques.",21,103,0,124
1189,1648360849126432768,2023-04-18 16:20:26,NemesisNemesi75,"« 250 jeunes étrangers isolés » la blague : l’immense majorité de ces migrants sont des HOMMES ADULTES depuis bien longtemps. Et qui ne viennent absolument pas de pays en guerre. On sait que vous êtes coutumiers du fait mais il va falloir arrêter de mentir @Utopia_56 « Utopia_56: Samedi, un collectif identitaire s'est rendu devant l’école désaffectée de Paris où survivent 250 jeunes étrangers isolés à la rue. Cette action haineuse visait à entraver notre mission humanitaire et harceler jeunes et bénévoles sur place. — https://twitter.com/utopia_56/status/1648005546698502146 »",204,585,17,806
1190,1648279464336412672,2023-04-18 10:57:02,NemesisNemesi75,"Du coup @nexity , @SwissLife_Fr , @agnesbofficiel et @LeaNature vous cautionnez les insultes sexistes des militants d’@Utopia_56 , association que vous financez?",18,50,3,71
1191,1648279461974999044,2023-04-18 10:57:01,NemesisNemesi75,"Sur Insta, @Utopia_56 « déplore les insultes émises contre notre collectif » par leurs militants. Les donateurs d’@Utopia_56 comme @nexity , @agnesbofficiel , @LeaNature ou @SwissLife_Fr financent donc des personnes qui traitent des femmes de « sales putes » #Boycott https://twitter.com/NemesisNemesi75/status/1648279461974999044/photo/1",137,226,5,368
1192,1648021940932624384,2023-04-17 17:53:44,NemesisNemesi75,"Ce genre de témoignage que vous ne verrez jamais chez @KonbiniFr @brutofficiel @Qofficiel et compagnie : « NemesisNemesi75: 🎥[TEMOIGNAGE]: Cette semaine Emilie témoigne de son agression à Paris. 

➡️Vidéo à voir en entier ici :
https://youtu.be/6445Pcf6I8I https://twitter.com/NemesisNemesi75/status/1647620882276270081/video/1 — https://twitter.com/nemesisnemesi75/status/1647620882276270081 »",64,122,3,189
1193,1647620888991236096,2023-04-16 15:20:05,NemesisNemesi75,"Si vous souhaitez nous aider, vous pouvez nous faire un don sur paypal à l’adresse collectif.nemesis@outlook.fr ou en cliquant sur le lien en bio",3,21,0,24
1194,1647620886273441793,2023-04-16 15:20:05,NemesisNemesi75,"Si toi aussi tu veux témoigner et ne plus avoir peur d’identifier tes agresseurs, contacte-nous à l’adresse : collectif.nemesis@outlook.fr",7,29,2,38
1195,1647620882276270081,2023-04-16 15:20:04,NemesisNemesi75,"🎥[TEMOIGNAGE]: Cette semaine Emilie témoigne de son agression à Paris. 

➡️Vidéo à voir en entier ici :
https://youtu.be/6445Pcf6I8I https://twitter.com/NemesisNemesi75/status/1647620882276270081/video/1",171,333,26,530
1196,1647559246110760961,2023-04-16 11:15:09,NemesisNemesi75,"« Sales putes » , « On va vous baiser », voilà le vrai visage des gens d’@Utopia_56 que les grands médias présentent comme des super-héros de l’humanitaire. Merci à @occidentisfr pour la vidéo. https://twitter.com/NemesisNemesi75/status/1647559246110760961/video/1",458,813,72,1343
1197,1647353423589695494,2023-04-15 21:37:17,NemesisNemesi75,"Alors que nos militantes venaient manifester pacifiquement contre le squat par des migrants d’une école abandonnée dans le 16eme arrondissement, elles ont été insultées par les militants d’@Utopia_56 : « Sales putes», «On va vous rouler dessus» et autres joyeusetés « CordierAlice2: « Sales putes » « je vais te baiser » « on va vous rouler dessus »

Nous venons d’être agressées par les militants de @Utopia_56 alors que nous faisions une action pacifiste devant une école du 16eme squattée par des migrants illégaux. https://twitter.com/CordierAlice2/status/1647331924002611201/video/1 — https://twitter.com/cordieralice2/status/1647331924002611201 »",75,120,9,204
1198,1647145302128771076,2023-04-15 07:50:17,NemesisNemesi75,https://www.itv.com/news/calendar/2023-04-14/42-truly-evil-men-jailed-for-child-sex-abuse-and-trafficking-of-girls,9,20,0,29
1199,1647145299863904259,2023-04-15 07:50:16,NemesisNemesi75,"Mohammed Kammer, Nahman Mohammed,Wiqas Mahmud, Mohammed Imran Ibrar, Abdul Rehman… Dans les différentes affaires de grooming-gang au Royaume-uni, les noms des condamnés sont toujours les mêmes et le profil des jeunes victimes aussi : des jeunes filles blanches vulnérables. https://twitter.com/NemesisNemesi75/status/1647145299863904259/photo/1",101,219,11,331
1200,1646766281771679745,2023-04-14 06:44:11,NemesisNemesi75,https://www.lunion.fr/id474896/article/2023-04-13/le-predateur-agresse-sexuellement-une-educatrice-dans-un-foyer-de-reims,3,7,0,10
1201,1646766280366538752,2023-04-14 06:44:11,NemesisNemesi75,"Le prévenu ne semble pas avoir beaucoup de considération pour la gente féminine. Interrogés au cours de l’enquête, ceux qui l’ont fréquenté le décrivent comme « très insultant avec les femmes ». « Ce qu’elles aiment dans le sexe, c’est la brutalité », disait-il également.",2,14,1,17
1202,1646766278835593217,2023-04-14 06:44:10,NemesisNemesi75,"À Reims, Ryan, un antillais de 25 ans résident de l’@ArmeeduSalut agresse sexuellement une éducatrice dans un foyer. Sursis et suivi sociojudiciaire ont ""sanctionné"" son comportement.",12,59,1,72
1203,1646572725270454273,2023-04-13 17:55:04,NemesisNemesi75,On remarquera que les manifestations sociales ou celles pour Charlie hebdo sont les seuls moments où ou ne voit pas un seul drapeau algérien 🇩🇿 ils nous manqueraient presque. #OnetwoThreeOuestlAlgérie ? « CerveauxNon: État lacrymal. Paris. Bastille. https://twitter.com/CerveauxNon/status/1646546166585098243/photo/1 — https://twitter.com/cerveauxnon/status/1646546166585098243 »,28,112,8,148
1204,1646546978333941761,2023-04-13 16:12:45,NemesisNemesi75,"@matoo56 c’est faux , les femmes et les hommes votent pareil : https://www.publicsenat.fr/article/politique/les-femmes-votent-elles-comme-les-hommes-192749?amp",0,0,0,0
1205,1646546283652345857,2023-04-13 16:10:00,NemesisNemesi75,@LesmediasM 66% des femmes (pour la population en entier c’est 64%),0,3,0,3
1206,1646520848118075394,2023-04-13 14:28:55,NemesisNemesi75,"Autrefois qualifiée de « surpuissance humanitaire », l’accueillante Suède revoit aujourd’hui totalement sa copie. Nous serions bien inspirés de les imiter très rapidement. https://twitter.com/NemesisNemesi75/status/1646520848118075394/photo/1",58,144,3,205
1207,1646512957931798530,2023-04-13 13:57:34,NemesisNemesi75,"À contrario, seulement 36% des sondés répondent « non »  à la question. https://twitter.com/NemesisNemesi75/status/1646512957931798530/photo/1",28,95,15,138
1208,1646503200680230912,2023-04-13 13:18:48,NemesisNemesi75,https://www.lunion.fr/id474651/article/2023-04-12/venu-cambrioler-une-maison-reims-le-voleur-de-bijoux-retrouve-couche-sur-le-lit,3,10,0,13
1209,1646503199090651136,2023-04-13 13:18:47,NemesisNemesi75,"À Reims, Khaled Bouhafa un Tunisien de 28 ans déjà sous OQTF a été retrouvé couché sur le lit de la nonagénaire qu’il cambriolait, des boîtes à bijoux ouvertes près de lui. Condamné à une interdiction de territoire de 10 ans, il est laissé libre à la sortie du tribunal",47,70,5,122
1210,1646397637300453377,2023-04-13 06:19:19,NemesisNemesi75,"Ces victimes qui ont vécu l’enfer n’auront droit qu’à un article payant dans le Parisien à la rubrique faits divers tellement ils sont devenus courants. Il y a 20 ans, cette affaire aurait fait la une des journaux pendant des semaines.",23,81,0,104
1211,1646397635878592513,2023-04-13 06:19:19,NemesisNemesi75,"Voilà la vie que les femmes ont à subir dans certaines cités en France et l’intimidation qui est réservée à ceux qui veulent les aider: ils seront menacés, comme cet homme anonyme qui a voulu aider cette jeune fille.",10,54,1,65
1212,1646397633043345408,2023-04-13 06:19:18,NemesisNemesi75,"Son calvaire enfin terminé, la jeune fille réussit à regagner son domicile. Ses parents l’emmènent immédiatement au commissariat. Ses violeurs ont été rapidement identifiés grâce notamment à l’analyse des images enregistrées par les caméras de vidéosurveillance et grâce à l’ADN.",6,32,1,39
1213,1646397631722078217,2023-04-13 06:19:18,NemesisNemesi75,Une cité qui savait ce qui se tramait dans les immeubles : un jeune avait lâché à une proche de la collégienne : « Ils la font tourner depuis quinze heures…»,6,31,1,38
1214,1646397630199521281,2023-04-13 06:19:18,NemesisNemesi75,"Elle y croit et elle les suit : elle est emmenée dans un second immeuble, puis un troisième, quasiment portée à chaque transfert, et pour finir, se retrouve dans une cave. Elle est alors «mise à la disposition» des copains du quartier qui abusent d’elle les uns après les autres.",6,29,1,36
1215,1646397628106645507,2023-04-13 06:19:17,NemesisNemesi75,L’un d’eux parvient à convaincre l’adolescente de descendre en lui promettant de lui rendre son téléphone portable et son manteau qui lui avaient été dérobés.,5,27,1,33
1216,1646397626609283072,2023-04-13 06:19:17,NemesisNemesi75,"Le résident découvre une adolescente apeurée, en pleurs, et la prend sous son aile pour l’emmener au commissariat. Il s’apprête à partir en voiture lorsqu’il se retrouve avec les jeunes. Cela s’embrouille :",6,42,1,49
1217,1646397625099223041,2023-04-13 06:19:17,NemesisNemesi75,Deux autres jeunes les rejoignent un peu plus tard. Ils lui imposent des relations sexuelles dans les escaliers et dans l’ascenseur. Un témoin surprend alors les jeunes et les met en fuite. L’un d’eux a encore le pantalon baissé.,6,41,1,48
1218,1646397623094452224,2023-04-13 06:19:16,NemesisNemesi75,"En février 2020, trois jeunes étaient venus l’attendre devant son collège à Villiers-le-Bel. À la pause de midi, ils la conduisent sous la contrainte dans un premier immeuble de la cité des Carreaux, toute proche.",7,28,1,36
1219,1646397621659893761,2023-04-13 06:19:16,NemesisNemesi75,Ils sont jugés par la cour d’assises des mineurs alors que 3 des accusés avaient 18 ans au moment des faits. Le procès est à huis-clos. L’avocat de la victime raconte : « Elle a vécu un calvaire absolu ». La victime est actuellement prise en charge par les institutions sociales.,6,38,1,45
1220,1646397619780956160,2023-04-13 06:19:15,NemesisNemesi75,[THREAD] Six jeunes de la cité des Carreaux sont jugés depuis lundi par la cour d’assises des mineurs du Val-d’Oise pour le viol collectif d’une jeune fille de 15 ans dans les immeubles et une cave du quartier. https://twitter.com/NemesisNemesi75/status/1646397619780956160/photo/1,118,209,6,333
1221,1646049554213502976,2023-04-12 07:16:10,NemesisNemesi75,"Une étudiante de 19 violée dans une laverie automatique à Bordeaux. Rapidement, un jeune de 18 ans correspondant au signalement de l’agresseur a été interpellé. Il a été placé en garde à vue. 

https://www.sudouest.fr/faits-divers/une-etudiante-depose-plainte-pour-un-viol-dans-une-laverie-automatique-a-bordeaux-14763032.php",20,41,1,62
1222,1646045500477505537,2023-04-12 07:00:04,NemesisNemesi75,"Deux gendarmes de Solesmes ont été mis en examen pour un viol en réunion commis à Caudry en 2021. La victime, une travailleuse du sexe de 22 ans qu’ils avaient pris en charge alcoolisée, a déclaré avoir repris conscience en plein acte.
https://www.lavoixdunord.fr/1314810/article/2023-04-11/elle-accuse-de-viol-deux-gendarmes-caudry-j-aimerais-que-ce-ne-soit-pas-mon",10,21,1,32
1223,1645855395469045761,2023-04-11 18:24:39,NemesisNemesi75,Même question pour les zététiciens du style @HygieneMentale @TroncheBiais … jamais là quand il faut 🥸,2,26,2,30
1224,1645853149415067649,2023-04-11 18:15:43,NemesisNemesi75,"À Rochdale en Angleterre, la vidéo d’un chauffeur #Uber abusant d’une jeune fille ivre de 13 ans fait scandale. L’homme qui surprend le chauffeur lui reproche de ne pas « respecter » le ramadan … https://twitter.com/NemesisNemesi75/status/1645853149415067649/video/1",284,430,53,767
1225,1645780052653625347,2023-04-11 13:25:16,NemesisNemesi75,Un «cela» sauvage est apparu dans notre tweet sans aucune raison. Veuillez nous excuser pour cette coquille.,3,43,1,47
1226,1645776597583118337,2023-04-11 13:11:32,NemesisNemesi75,"Bonjour @CheckNewsfr , pouvez-vous « fact-checker » toutes ces affirmations de @GIMS cela vous qui êtes des spécialistes des debunkages en tout genre s’il vous plait ? « F_Desouche: Le chanteur @GIMS affirme que les noirs étaient des chevaliers et qu’ils ont peuplé l’Europe avant d’être décimé par les blancs. Ils avaient aussi l’électricité. Tout cela serait caché par les historiens.

https://twitter.com/renardbordelais/status/1645597208216064004/video/1 — https://twitter.com/f_desouche/status/1645751661296513025 »",182,984,51,1217
1227,1645772013661822977,2023-04-11 12:53:19,NemesisNemesi75,https://www.midilibre.fr/2023/04/11/direct-betty-19-ans-enfermee-47-jours-dans-un-placard-a-agde-suivez-le-proces-de-limpensable-aux-assises-de-lherault-11125997.php,0,15,0,15
1228,1645772012269305857,2023-04-11 12:53:19,NemesisNemesi75,"Ce mardi s’ouvre le procès de Séverine Chatain et ses fils Jordan et Jason Garde. Tous les 3 accusés de tentative d'assassinat, les 2 fils sont aussi poursuivis pour séquestration avec acte de torture et barbarie. La victime, Betty, a été séquestrée 47 jours dans un placard .",20,58,1,79
1229,1645769594223591424,2023-04-11 12:43:42,NemesisNemesi75,"On savait déjà que #LFI était pour le voile des femmes et maintenant ils sont aussi pour les baffes pour les femmes. 

Quelle sera la prochaine étape ? 🙃 https://twitter.com/NemesisNemesi75/status/1645769594223591424/photo/1",100,188,20,308
1230,1645667828358344705,2023-04-11 05:59:19,NemesisNemesi75,"Si notre association a pu être poursuivie juridiquement pour un simple dessin qui n’attaquait personne nommément, qu’en sera-t-il pour @Medinrecords ? Va-t-on assister encore une fois à un spectaculaire deux poids deux mesures de la part de la justice française ?",10,42,1,53
1231,1645667826064056321,2023-04-11 05:59:19,NemesisNemesi75,"Quand les rappeurs ne traitent pas les femmes de « pute » toutes les 5 secondes, ils jettent en pâture des piñatas représentant des femmes avec lesquelles ils sont en désaccord politiquement. Les violences contre les femmes, même symbolique, nous n’en voulons plus. « diaz_edwige: Depuis l’@ademflorida, @sudouest nous apprend que Médine a confectionné une Piñata à mon effigie et à celle de @jrechagneux. Il l’a ensuite « offerte en pâture au public, qui s’en est facilement occupé ».

Nous ne laisserons pas cette affaire sans suite.

https://www.sudouest.fr/lot-et-garonne/le-rappeur-medine-au-florida-merci-agen-de-ne-pas-vous-etre-laisses-intimider-14740531.php https://twitter.com/diaz_edwige/status/1645505136649994240/photo/1 — https://twitter.com/diaz_edwige/status/1645505136649994240 »",92,251,6,349
1232,1645359268189618179,2023-04-10 09:33:13,NemesisNemesi75,"Excellente vidéo du @lelapindufutur sur la position relativiste des gauchistes français concernant le voile. 

À voir ici : https://youtu.be/qGMq2Rcjf6k https://twitter.com/NemesisNemesi75/status/1645359268189618179/photo/1",20,88,2,110
1233,1645339507716128769,2023-04-10 08:14:42,NemesisNemesi75,"Déjà connu de la justice pour des viols, Houd O., un homme de 25 ans au « profil particulièrement inquiétant », tente d’enlever une collégienne de 11 ans à Paris le 28 mars dernier. https://www.leparisien.fr/faits-divers/paris-arme-dun-couteau-un-homme-au-profil-particulierement-inquietant-tente-denlever-une-collegienne-09-04-2023-IL5PNKSAUVA7HO4LIUTQFTOZIA.php",32,50,2,84
1234,1645090911741792256,2023-04-09 15:46:52,NemesisNemesi75,"Si vous voulez nous aider à réaliser plus de vidéos témoignages, vous pouvez le faire en nous faisant un don à la même adresse sur paypal ou en cliquant sur le lien en bio de notre twitter ! 💙",1,13,0,14
1235,1645090909837574152,2023-04-09 15:46:51,NemesisNemesi75,"Si toi aussi tu veux témoigner et ne plus avoir peur d’identifier tes agresseurs, contacte-nous à l’adresse : collectif.nemesis@outlook.fr",3,17,1,21
1236,1645090905769095168,2023-04-09 15:46:50,NemesisNemesi75,"🎥[TEMOIGNAGE]: Cette semaine @mathildaNemesis témoigne de l’enfer du métro parisien et de ses tristement célèbres frotteurs.

➡️Vidéo à voir en entier ici :

https://youtu.be/7_OxmO4fEtI https://twitter.com/NemesisNemesi75/status/1645090905769095168/video/1",147,248,11,406
1237,1644957817827147778,2023-04-09 06:58:00,NemesisNemesi75,"Le Collectif Némésis vous souhaite de joyeuses fêtes de Pâques. 

Fête chrétienne la plus importante pour les uns, symbole de renaissance et de l’arrivée du printemps pour les autres, elle est dans tous les cas l’occasion de se ressembler en famille.

Profitez-en bien. 💙💙💙 https://twitter.com/NemesisNemesi75/status/1644957817827147778/photo/1",49,278,8,335
1238,1644231730650390529,2023-04-07 06:52:47,NemesisNemesi75,https://www.eurosport.fr/football/ligue-1/2022-2023/angers-ilyes-chetti-ecope-de-quatre-mois-de-prison-avec-sursis-pour-agression-sexuelle_sto9546166/story-amp.shtml,0,10,0,10
1239,1644231729165598720,2023-04-07 06:52:47,NemesisNemesi75,"Cette agression sexuelle avait indirectement provoqué le départ de l’entraîneur d'Angers, Abdel Bouhazama. Dans la causerie d'avant-match, le 5 mars à Montpellier, le coach angevin avait défendu son joueur en disant: ""Ce n'est pas méchant, on a déjà tous touché des filles"".",2,33,1,36
1240,1644231727534030848,2023-04-07 06:52:46,NemesisNemesi75,L'international algérien et joueur du SCO d'Angers Ilyes Chetti a été condamné ce jeudi à 4 mois de prison avec sursis pour agression sexuelle sur une jeune femme. Il avait reconnu les faits reprochés.,33,95,2,130
1241,1644230165784928256,2023-04-07 06:46:34,NemesisNemesi75,"Yoann Touzeau, propriétaire de l’institution charentaise « Maison Pezaud » vient d’être écroué pour viol, agressions sexuelles et harcèlement. https://www.charentelibre.fr/societe/justice/le-patron-de-la-maison-pezaud-mis-en-examen-pour-viol-et-agressions-sexuelles-14707910.php",12,22,0,34
1242,1644228402910486528,2023-04-07 06:39:34,NemesisNemesi75,APPEL À TÉMOINS : La police de Vienne lance un appel pour retrouver un homme soupçonné d'avoir violé une étudiante près de la gare d'Estressin en janvier 2021. Si vous avez des informations vous pouvez contacter le commissariat au 04.74.78.06.78 ou par mail GPF38200@gmail.com https://twitter.com/NemesisNemesi75/status/1644228402910486528/photo/1,35,32,0,67
1243,1643886884815339521,2023-04-06 08:02:29,NemesisNemesi75,"Deux ans de prison seulement pour l’un des violeurs d’une fillette de 11 ans. Les deux autres écopent seulement de 18 mois ferme. Visiblement il n’y a pas qu’en France que la justice se moque des victimes: au Maroc aussi. 🇲🇦 

https://www.leparisien.fr/amp/faits-divers/maroc-manifestation-contre-un-verdict-juge-laxiste-apres-le-viol-dune-fillette-05-04-2023-J62HPES4DNCSVEZDGKAUKIIF4M.php",38,84,1,123
1244,1643884222535327746,2023-04-06 07:51:55,NemesisNemesi75,https://www.leparisien.fr/amp/oise-60/jai-reconnu-mon-corps-le-temoignage-de-maeva-traumatisee-par-la-decouverte-de-la-video-de-son-viol-03-04-2023-56KDGHVW35D5BC4CRKM2UQZM6I.php,5,13,0,18
1245,1643884220983410688,2023-04-06 07:51:54,NemesisNemesi75,"Après la découverte des vidéos, il faudra encore attendre février 2020 pour que Laurent R soit retrouvé. Celui-ci s’était enfui dans le sud de la France. Ce mardi 4 avril, lui et son complice ont été reconnus coupables des faits qui leur sont reprochés.",2,11,1,14
1246,1643884219431636992,2023-04-06 07:51:54,NemesisNemesi75,"Pour Me Lauralane Bao, l’avocate de la beauvaisienne de 28 ans, “heureusement que ces deux vidéos ont été retrouvées. Sans cela, c’est un dossier qui n’aurait sûrement jamais abouti.”",1,10,1,12
1247,1643884217875456008,2023-04-06 07:51:54,NemesisNemesi75,"Ces vidéos, Maéva n’a jamais eu la force de les regarder entièrement. “J’ai vu la première image seulement (…) J’ai reconnu mon corps dessus. Le reste, j’ai demandé à mon compagnon de le regarder.”",1,9,1,11
1248,1643884216315174915,2023-04-06 07:51:53,NemesisNemesi75,"On y voit tout d’abord ce dernier, caressant les fesses dénudées de la jeune femme. Puis sur une seconde vidéo, Laurent R la viole alors qu’elle est complètement inerte.",1,8,1,10
1249,1643884214897573889,2023-04-06 07:51:53,NemesisNemesi75,"La preuve qui va tout changer : ce sont des vidéos. Un mois après les faits, alors que Maéva trie des photos sur son Cloud, elle tombe sur deux vidéos filmées par le téléphone qu’elle avait alors prêté à son agresseur, Mohamed K.",1,10,1,12
1250,1643884213576384513,2023-04-06 07:51:53,NemesisNemesi75,"À son réveil quelques heures plus tard, Maéva s’était vomi dessus. Kévin se rend compte qu’elle a le pantalon et la culotte baissée, ce qui va tout de suite lui faire suspecter le pire. “Je lui ai dit d’aller à l’hôpital mais elle ne voulait pas car elle n’avait pas de preuves.”",1,10,1,12
1251,1643884212062232577,2023-04-06 07:51:52,NemesisNemesi75,"Une dispute éclate, et Laurent R finit par frapper Kévin, insistant pour qu’il aille se coucher en laissant là sa compagne. Le jeune homme admet avoir eu peur de Mohamed K, il cède.",1,10,1,12
1252,1643884210107609090,2023-04-06 07:51:52,NemesisNemesi75,"C’est Kévin qui raconte la suite. “J’ai essayé de la porter dans notre chambre. Mais elle était comme un poids mort et je l’ai fait tomber.” Selon le jeune homme, Laurent R et Mohamed K lui auraient demandé de la laisser dans la chambre de ce dernier, où ils se trouvaient.",1,9,1,11
1253,1643884208719380480,2023-04-06 07:51:51,NemesisNemesi75,"«Tout se passait bien» témoigne Maéva au Parisien. La jeune femme d’aujourd’hui 28 ans part chercher une glace, puis c’est le trou noir. “Je me souviens l'avoir ouverte. Et puis plus rien” dit-elle.",2,11,1,14
1254,1643884207171678208,2023-04-06 07:51:51,NemesisNemesi75,"Rappel des faits : en novembre 2019, à Beauvais, Maeva et son compagnon Kévin (les deux prénoms ont été modifiés) invitent Laurent R et Mohamed K., respectivement un voisin et un ami logeant chez eux depuis quelque temps.",3,23,1,27
1255,1643884205183496194,2023-04-06 07:51:51,NemesisNemesi75,"Laurent R écope de huit ans de prison ferme et Mohamed K son complice est de son côté condamné à cinq ans dont deux de sursis pour le viol de leur voisine, Maeva, qui avait découvert les images de son viol sur un téléphone un mois après les faits.",40,114,6,160
1256,1643693303899082752,2023-04-05 19:13:16,NemesisNemesi75,https://www.varmatin.com/faits-de-societe/francoise-dumont-senatrice-lr-du-var-depose-plainte-apres-avoir-recu-des-menaces-sur-les-reseaux-sociaux-835341,3,9,0,12
1257,1643693302288379905,2023-04-05 19:13:16,NemesisNemesi75,Une sénatrice est menacée suite à un amendement dans le cadre du projet de loi immigration. Il est inacceptable d’être menacée en raison de ses convictions politiques. Soutien à @FrDumont83. La critique de l’immigration et de ses pompes aspirantes est-elle encore possible ?,77,201,3,281
1258,1643658786245050378,2023-04-05 16:56:07,NemesisNemesi75,"À l’heure ou des antifas violents sont invités à l’@AssembleeNat , cette #ConventionReconquete contre les #ViolencesExtremeGauche est une excellente initiative.

 @Reconquete_off « Samuel_Lafont: Témoignage de @CordierAlice2 du Collectif Némésis @NemesisNemesi75 sur les agresseurs d’extrême-gauche.

#ConventionReconquete #ViolencesExtremeGauche https://twitter.com/Samuel_Lafont/status/1643654548194459652/photo/1 — https://twitter.com/samuel_lafont/status/1643654548194459652 »",167,439,10,616
1259,1643497399082713095,2023-04-05 06:14:49,NemesisNemesi75,"Récemment sorti de prison pour vol avec violences et condamné à de multiples reprises, un homme de 29 ans tente de tuer son ex-compagne à Châtillon :

https://actu17.fr/faits-divers/hauts-de-seine-recemment-sorti-de-prison-il-tente-de-tuer-son-ex-compagne.html",20,39,0,59
1260,1643154627523907586,2023-04-04 07:32:46,NemesisNemesi75,@CordierAlice2 https://twitter.com/NemesisNemesi75/status/1643154627523907586/photo/1,0,8,0,8
1261,1643150874384973825,2023-04-04 07:17:51,NemesisNemesi75,"C’est eux aussi qui en 2021 à la manif #noustoutes a agressé nos militantes à coups de projectiles alors qu’elles venaient dénoncer différents viols , agressions sexuelles et meurtres de femmes.

Nous pouvons d'ailleurs voir dans la vidéo Raphael Arnault : https://youtu.be/ova5jbEuAFI https://twitter.com/NemesisNemesi75/status/1643150874384973825/photo/1",28,54,0,82
1262,1643150034718846976,2023-04-04 07:14:31,NemesisNemesi75,C’est ce même groupuscule qui s’est vanté d’avoir agressé @ZemmourEric à la sortie de son train : https://twitter.com/NemesisNemesi75/status/1643150034718846976/photo/1,11,38,2,51
1263,1643149838802878467,2023-04-04 07:13:44,NemesisNemesi75,"Pour rappel, c’est ce même groupuscule qui la semaine dernière à peine, revendiquait le lynchage et diffusait la séance d'humiliation sadique d'un militant de droite qui s'opposait au blocus de sa fac « F_Desouche: Lyon : Le mouvement antifa ""Jeune garde"" revendique et diffuse la séance d'humiliation sadique d'un militant de droite qui s'opposait à un blocus  https://twitter.com/ZemmourEric/status/1640754229676572673/video/1 — https://twitter.com/f_desouche/status/1640763020824510465&t=gua99yxzpofxtgl6htutww »",7,36,2,45
1264,1643142456806985729,2023-04-04 06:44:24,NemesisNemesi75,Donc l’@AssembleeNat a reçu sur invitation d’@Aurelientache @ArnaultRaphael de la milice d’EG la Jeune Garde qui a lynché un homme il y a une semaine ? C’est un poisson d’avril en retard rassurez-nous ? La prochaine étape c’est Tariq Ramadan invité pour parler de l’islamophobie ? https://twitter.com/NemesisNemesi75/status/1643142456806985729/photo/1,171,319,11,501
1265,1642812366386524160,2023-04-03 08:52:44,NemesisNemesi75,Une touriste allemande d’origine russe a échappé à un viol près de la tour Eiffel dans la nuit de samedi à dimanche. Le suspect à priori d’origine moldave a été interpellé grâce à l’intervention d’un vendeur à la sauvette pakistanais. https://www.cnews.fr/faits-divers/2023-04-02/paris-une-touriste-allemande-echappe-un-viol-pres-de-la-tour-eiffel-1339881?amp,40,147,6,193
1266,1642809676130578435,2023-04-03 08:42:03,NemesisNemesi75,"Joseph V., un homme de 50 ans, a été arrêté le 21 mars à Paris après avoir tenté de violer une collégienne. Son passé judiciaire a montré qu'il avait été condamné pour des faits similaires en 1992,1996, 2006, 2007, 2013, et 2020. https://www.midilibre.fr/2023/04/01/agressions-sexuelles-et-viols-dadolescentes-enquete-a-paris-sur-un-suspect-au-profil-de-criminel-en-serie-11104879.php",52,76,7,135
1267,1642531927193268224,2023-04-02 14:18:22,NemesisNemesi75,"Si toi aussi tu veux témoigner et ne plus avoir peur d’identifier tes agresseurs, contacte-nous à l’adresse : collectif.nemesis@outlook.fr",9,18,1,28
1268,1642531925737734145,2023-04-02 14:18:22,NemesisNemesi75,"Si vous souhaitez nous aider, vous pouvez nous faire un don sur paypal à l’adresse collectif.nemesis@outlook.fr ou en cliquant sur le lien en bio twitter",7,11,1,19
1269,1642531922692669444,2023-04-02 14:18:21,NemesisNemesi75,"Le harcèlement de rue est partout, tout le temps. Léa nous décrit son quotidien de jeune femme. 
Vidéo à voir entier ici : https://youtu.be/QcnLYQSzyyY https://twitter.com/NemesisNemesi75/status/1642531922692669444/video/1",345,685,32,1062
1270,1642081676984459264,2023-04-01 08:29:14,NemesisNemesi75,"Ce mois-ci, @netflix pousse le bouchon un peu loin 🤡 https://twitter.com/NemesisNemesi75/status/1642081676984459264/photo/1",122,389,49,560
1271,1641773737283403777,2023-03-31 12:05:36,NemesisNemesi75,https://www.leparisien.fr/seine-saint-denis-93/il-avait-tue-la-meilleure-des-meres-a-aubervilliers-8-ans-de-prison-pour-le-chauffard-multirecidiviste-30-03-2023-XYDM3NSDZ5CO3E3EAO77VHJRQA.php,6,10,0,16
1272,1641773734921945088,2023-03-31 12:05:35,NemesisNemesi75,"Ibrahim D., un conducteur ivre et sans permis qui avait tué une femme de 70 ans en 2021 à Aubervilliers vient d’être condamné à huit ans de prison dont deux années de sursis probatoire renforcé. Il comptait déjà à son casier judiciaire une dizaine de condamnations.",21,57,2,80
1273,1641769776199393280,2023-03-31 11:49:51,NemesisNemesi75,https://twitter.com/NemesisNemesi75/status/1641769776199393280/photo/1,4,21,1,26
1274,1641769763608178691,2023-03-31 11:49:48,NemesisNemesi75,"Pour la maire de Lille @MartineAubry , il est visiblement plus facile de faire fermer des bars que de lutter contre la violence qui est entrain de ravager sa ville : https://twitter.com/NemesisNemesi75/status/1641769763608178691/photo/1",82,164,2,248
1275,1641390339293433862,2023-03-30 10:42:07,NemesisNemesi75,"Le 18 janvier, une douaisienne avait été agressée sexuellement par un irakien. Ce dernier vient d’être condamné par le tribunal correctionnel à seulement 18 mois de prison assortie d’un sursis simple et d’une interdiction de territoire pendant 3 ans. https://www.lavoixdunord.fr/1309179/article/2023-03-29/douai-un-ressortissant-etranger-condamne-pour-agression-sexuelle",43,52,3,98
1276,1641389092662308865,2023-03-30 10:37:09,NemesisNemesi75,"Nous connaissons cette théorie 👀 « Flasholl1: Ma fille est allée chez Zara cet après-midi.
Papa c’était super. Calme, tout bien rangé, propre. Pour une fois c’était agréable. 

Huhummmm …  je vois 🙄 — https://twitter.com/flasholl1/status/1641107052851351553 »",6,63,4,73
1277,1641041904715415555,2023-03-29 11:37:33,NemesisNemesi75,"⚠️Le procès en appel pour l'agression sexuelle de Shaïna, aura lieu à Amiens la semaine prochaine, son meurtrier lui, sera jugé devant la cour d'assises des mineurs de Beauvais en juin prochain. Cela fait plus de 6 ans que sa famille attend. Rappel de son histoire histoire ici : « NemesisNemesi75: La mère de Shaina, dit déjà que, dans sa cité, ""c'est comme en Afghanistan"". Nous sommes d'autant plus triste car nous savons que la situation va empirer: une vague d'immigrés afghans pour lesquels les crimes d'honneur sont la norme, va déferler bientôt sur la France. https://twitter.com/NemesisNemesi18/status/1434583966800093188/photo/1 — https://twitter.com/nemesisnemesi75/status/1434583966800093188 »",59,98,8,165
1278,1640729163475697666,2023-03-28 14:54:50,NemesisNemesi75,Source : http://www.justice.gouv.fr/statistiques-10054/statistiques-trimestrielles-de-milieu-ferme-34262.html,2,7,0,9
1279,1640729061470228482,2023-03-28 14:54:26,NemesisNemesi75,"Des violeurs courent en liberté selon le ministère de la justice :

Au 31 déc. 2022, 754 violeurs condamnés pour agression sexuelle étaient non détenus dans les prisons françaises. 
Allo, @justice_gouv ? 

NB : sans compter les mineurs. https://twitter.com/NemesisNemesi75/status/1640729061470228482/photo/1",125,140,4,269
1280,1640643455087964167,2023-03-28 09:14:16,NemesisNemesi75,"Evelyn Dieckhaus, Hallie Scruggs et William Kinney, tous âgés de 9 ans, ont été tués par balle.
Katherine Koonce, 60 ans, et Cynthia Peak et Mike Hill, tous deux âgés de 61 ans, figuraient également parmi les six victimes. https://twitter.com/NemesisNemesi75/status/1640643455087964167/photo/1",22,83,0,105
1281,1640643449807417345,2023-03-28 09:14:14,NemesisNemesi75,"Le mobile, encore inconnu, pourrait être lié à une « rancune » à l’encontre de cette école, a noté le chef de la police de Nashville, John Drake.",12,49,1,62
1282,1640643447735349249,2023-03-28 09:14:14,NemesisNemesi75,"Audrey Hale a été présentée par la police comme une personne née femme mais faisant ensuite référence à elle-même, sur un réseau social, comme « il/lui », ce qui laisse entendre qu’elle était une personne transgenre. https://twitter.com/NemesisNemesi75/status/1640643447735349249/photo/1",18,72,4,94
1283,1640643442794549249,2023-03-28 09:14:13,NemesisNemesi75,"Hier, la personne qui a tué six personnes, dont trois enfants, dans une école élémentaire chrétienne de Nashville dans le Tennessee, a été identifié comme étant Audrey Elizabeth Hale. https://twitter.com/NemesisNemesi75/status/1640643442794549249/photo/1",100,357,23,480
1284,1640628769810526208,2023-03-28 08:15:54,NemesisNemesi75,"Les femmes SDF sont en proie aux viols et aux agressions sexuelles.
D’après les chiffres de l’INSEE en 2012, 38% des SDF étalent des femmes. 

Le plus important est de prendre le temps de discuter, s’intéresser, écouter et de partager un moment autour d’une boisson chaude.",5,29,2,36
1285,1640628767193280513,2023-03-28 08:15:54,NemesisNemesi75,"Maraude auprès des sans abris pour la section parisienne.

Équipées de thermos pour les boissons chaudes, de nourriture et aussi de vêtements, les militantes de Némésis parcourent les rues à la rencontre des personnes sans abri, avec une attention particulière pour les femmes. https://twitter.com/NemesisNemesi75/status/1640628767193280513/photo/1",46,159,3,208
1286,1640348583332311045,2023-03-27 13:42:33,NemesisNemesi75,"La reine Charlotte, épouse du roi George III s’appelait Charlotte de Mecklembourg-Strelitz et possédait PEUT-ÊTRE 0,003% de gènes maures. Pas de quoi la transformer en princesse noire donc.",12,78,4,94
1287,1640348580803231745,2023-03-27 13:42:32,NemesisNemesi75,C’est encore le cas dans « La Reine Charlotte » où Netflix met l’anachronisme au service de la sainte inclusivité. https://twitter.com/NemesisNemesi75/status/1640348580803231745/photo/1,16,94,1,111
1288,1640348569180815365,2023-03-27 13:42:29,NemesisNemesi75,Celui des Européennes célèbres remplacées par des femmes « racisées » dans des films ou des séries sous couvert de « liberté artistique ».  Une « liberté artistique » toujours à sens unique et qui semble plus répondre du cahier des charges que de la véritable liberté artistique.,14,92,1,107
1289,1640348567519780868,2023-03-27 13:42:29,NemesisNemesi75,"Nous avons des tas d’exemples où des hommes en jupe prennent la place de femmes. Mais il existe aussi un autre « grand remplacement », plus insidieux :",26,132,2,160
1290,1640252606990671872,2023-03-27 07:21:10,NemesisNemesi75,La présidente de la région Île-de-France @vpecresse menace de sanctionner financièrement l’association @osezlefeminisme suite aux propos de la porte-parole Violaine de Filippis qui a attribué les féminicides en France à « la culture judéo-chrétienne ». https://www.google.fr/amp/s/amp.lepoint.fr/2513265,11,46,3,60
1291,1640246440076165125,2023-03-27 06:56:40,NemesisNemesi75,"Ahmed Bengaoua, un multirécidiviste schizophrène déjà condamné 28 fois arrêté après l’agression de deux lycéennes. Il écope d’un an ferme seulement  https://www.ledauphine.com/faits-divers-justice/2023/03/25/isere-un-an-de-prison-ferme-pour-l-agression-de-deux-lyceennes-a-grenoble",16,20,0,36
1292,1640241815193354241,2023-03-27 06:38:17,NemesisNemesi75,https://www.leparisien.fr/paris-75/paris-une-jeune-femme-battue-a-mort-dans-son-hall-dimmeuble-26-03-2023-5REGWD3RNFFTTI5F7Q2QYJ455A.php,5,17,1,23
1293,1640241813452718080,2023-03-27 06:38:17,NemesisNemesi75,"Paris : une jeune femme retrouvée battue à mort dans le hall de son immeuble. La victime, âgée de 29 ans, a été retrouvée par son compagnon, inquiet de ne pas la voir rentrer d’une soirée entre amis. Pour l’heure, les policiers n’ont aucun suspect en ligne de mire.",50,145,6,201
1294,1640240438891118593,2023-03-27 06:32:49,NemesisNemesi75,"Au Royaume-uni, le harcèlement de rue sera passible d’une peine maximale de deux ans de prison. https://www.oxfordmail.co.uk/news/23412251.people-wolf-whistle-will-get-two-years-prison-law-changes/",3,12,0,15
1295,1640237527981277184,2023-03-27 06:21:15,NemesisNemesi75,https://www.leparisien.fr/amp/essonne-91/assises-de-lessonne-un-homme-juge-pour-avoir-viole-une-adolescente-dans-une-cave-a-savigny-23-03-2023-NR6WARJU6ZHCNORUFH5L2B2WNM.php,2,5,0,7
1296,1640237526362255360,2023-03-27 06:21:15,NemesisNemesi75,"Un homme condamné à 6 ans de prison pour le viol d’une adolescente dans une cave à Savigny-sur-Orge. En 2014, un mandat de recherche avait été émis à son encontre, sa famille ayant indiqué qu’il était reparti au Portugal. Le suspect avait été interpellé au Portugal fin 2019.",6,33,2,41
1297,1640235598270087169,2023-03-27 06:13:35,NemesisNemesi75,"Un radiologue mis en examen pour viol sur une patiente en Essonne. D'origine tunisienne, son passeport lui a été retiré afin d'éviter tout départ à l'étranger, a souligné le parquet. https://amp.lefigaro.fr/flash-actu/essonne-un-radiologue-mis-en-examen-pour-viol-sur-une-patiente-20230326",3,11,0,14
1298,1640234315844841472,2023-03-27 06:08:29,NemesisNemesi75,https://www.sudouest.fr/justice/juge-pour-trois-viols-et-23-agressions-sexuelles-le-dentiste-massait-et-photographiait-ses-patientes-14561129.php,0,2,0,2
1299,1640234313856974849,2023-03-27 06:08:29,NemesisNemesi75,"Le Dr Stéphane Schoener est jugé à partir d’aujourd’hui à Orléans. Ce dentiste est accusé d’avoir commis 3 viols et 23 agressions sexuelles sur une vingtaine de victimes, dont certaines étaient mineures. Il a profité de séances d’acupuncture, pour commettre les agressions.",8,35,1,44
1300,1640056655437021185,2023-03-26 18:22:32,NemesisNemesi75,"Révélant alors au monde ce que l’Angleterre voulait cacher : oui, en Europe, des jeunes filles blanches sont violées en masse par des gangs indo-pakistanais.",6,38,1,45
1301,1640056653830668292,2023-03-26 18:22:31,NemesisNemesi75,"Pour ses liens avec « l’extrême droite »: elle a soutenu Tommy Robinson, un homme condamné à 9 mois de prison pour avoir filmé des violeurs pakistanais et pour avoir diffusé les images de ces violeurs avant le procès.",7,43,1,51
1302,1640056651922173952,2023-03-26 18:22:31,NemesisNemesi75,"Pour rappel et pour faire cesser leurs mensonges, voici les ""propos violents "" en question :
« Une femme est un être humain adulte de sexe féminin ».",5,36,1,42
1303,1640056650043211779,2023-03-26 18:22:30,NemesisNemesi75,"Les pseudos journalistes du magazine @Slatefr nous expliquent dans leur article consacré à cette agression que Posie Parker est connue pour ""ses propos violents"" et ses ""liens avec l’extrême-droite "" justifiant la violence bien réelle elle, qu’a subie Posie Parker.",4,30,1,35
1304,1640049667101581313,2023-03-26 17:54:45,NemesisNemesi75,"Posie Parker, une militante britannique pour les droits des femmes a été encerclée, huée, frappée et a dû mettre fin à sa tournée « Let Women Speak »

Merci au lobby trans 🏳️‍⚧️ qui, grâce à sa haine, nous fait revivre l’époque où des femmes étaient menées au bûcher. 🧙‍♀️ https://twitter.com/NemesisNemesi75/status/1640049667101581313/video/1",69,173,3,245
1305,1639560337916567552,2023-03-25 09:30:20,NemesisNemesi75,"@JulietteBriens Je suppose que tu l’as déjà fait mais n’hésite pas à le signaler à la compagnie VTC que tu as utilisée. Nous sommes obligées de commander des VTC pour espérer rentrer tranquille et même là, ce n’est pas le cas et on tombe sur des « musulmans modérés ».",7,34,0,41
1306,1639294974586912769,2023-03-24 15:55:53,NemesisNemesi75,Lyon : Najib M. et Farouk B. condamnés à 20 ans et 11 ans de réclusion criminelle. pour avoir séquestré et violé à plusieurs reprises deux jeunes femmes dans un bar à chicha. https://www.leprogres.fr/amp/faits-divers-justice/2023/03/23/viols-dans-un-bar-a-chicha-les-accuses-condamnes-a-20-et-11-ans-de-reclusion,76,102,7,185
1307,1639198402788376580,2023-03-24 09:32:08,NemesisNemesi75,Octogénaire mortellement fauchée par un scooter à Brest : deux « jeunes»  de 16 ans placés en garde à vue. Ils étaient déjà défavorablement connus de la police. https://www.ladepeche.fr/amp/2023/03/23/octogenaire-mortellement-fauchee-par-un-scooter-a-brest-deux-adolescents-de-16-ans-places-en-garde-a-vue-11084123.php,7,17,0,24
1308,1639192383370989568,2023-03-24 09:08:13,NemesisNemesi75,https://m.20minutes.fr/amp/a/4029167,7,30,0,37
1309,1639192380879298561,2023-03-24 09:08:12,NemesisNemesi75,"Hier, le procès de Dylan et Jessy Vandromme (deux frères) et de Cécile Vandromme (la femme de l’un d’eux) s’est ouvert pour 7 jours. Ils sont accusés d’avoir séquestré une Dunkerquoise de 18 ans, lui infligeant pendant 6 semaines des viols, des actes de barbarie et torture. https://twitter.com/NemesisNemesi75/status/1639192380879298561/photo/1",80,207,14,301
1310,1639189702505791489,2023-03-24 08:57:34,NemesisNemesi75,"À partir du 31 mars, les personnes transgenres seront bannies des compétitions internationales féminines d’athlétisme a annoncé ce jeudi le président de World Athletics. https://www.sudouest.fr/sport/athletisme/athletisme-les-personnes-transgenres-bannies-des-competitions-feminines-14542460.php",19,80,3,102
1311,1638904224288317441,2023-03-23 14:03:11,NemesisNemesi75,"Tiffany Thomas, un cycliste transgenre de 46 ans remporte la première place d’une course féminine à New York. https://www.google.com/amp/s/www.dailymail.co.uk/news/article-11892441/amp/Transgender-athlete-46-wins-female-NYC-cycling-event-says-feels-like-superhero.html https://twitter.com/NemesisNemesi75/status/1638904224288317441/photo/1",58,113,30,201
1312,1638895964185296896,2023-03-23 13:30:21,NemesisNemesi75,"Cécile Hussherr-Poisson, normalienne et agrégée de lettres a été poignardée à mort par son ex-mari, normalien lui aussi, le 20 mars dernier. Il s’était déguisé en livreur Deliveroo pour la tuer. https://www.lefigaro.fr/faits-divers/c-est-une-perte-immense-qui-etait-cecile-hussherr-poisson-l-agregee-de-lettres-poignardee-par-son-ex-mari-dans-son-immeuble-a-paris-20230323",15,32,0,47
1313,1638856980298346499,2023-03-23 10:55:27,NemesisNemesi75,"Annecy : un homme plusieurs fois condamné, dont une fois pour viol, poursuivi pour récidives de viols et récidive de proxénétisme sur deux jeunes femmes, dont Mélanie, une femme handicapée de 19 ans. https://twitter.com/NemesisNemesi75/status/1638856980298346499/photo/1",38,92,3,133
1314,1638856255933390848,2023-03-23 10:52:34,NemesisNemesi75,Samir Bensghir vient d’être condamné à six ans de prison pour le viol d’une habitante de La Chapelle-Saint-Ursin en octobre 2017 https://www.leberry.fr/bourges-18000/actualites/condamne-a-six-ans-de-prison-pour-le-viol-dune-habitante-du-cher-rencontree-a-la-sortie-d-une-discotheque-du-loiret_14281254/,9,26,0,35
1315,1638851724055019520,2023-03-23 10:34:34,NemesisNemesi75,"Monsieur @PapNdiaye, des élèves se rendent en cours voilées à Cergy au lycée Galilée. Vous êtes grassement payé pour régler ce genre de problèmes donc faites votre travail. https://letudiantlibre.fr/filles-voilees-comment-le-lycee-galilee-applique-la-laicite-a-sa-maniere-2/",55,120,9,184
1316,1638583575988641807,2023-03-22 16:49:02,NemesisNemesi75,"A Vesoul (Haute-Saône), deux femmes agressées « sans raison apparente », une en « urgence absolue » par un homme âgé d’une quarantaine d’années, portant une sorte de djellaba et un turban sur la tête. https://www.estrepublicain.fr/faits-divers-justice/2023/03/22/deux-femmes-agressees-sans-raison-apparente-une-en-urgence-absolue",28,44,5,77
1317,1638474083460435970,2023-03-22 09:33:57,NemesisNemesi75,Nice : Une jeune femme de 19 ans agressée sexuellement par un Tunisien 🇹🇳 armé d'un couteau https://actu17.fr/faits-divers/nice-une-jeune-femme-de-19-ans-agressee-sexuellement-par-un-homme-arme-dun-couteau.html,9,29,0,38
1318,1638471556358721536,2023-03-22 09:23:55,NemesisNemesi75,https://www.lefigaro.fr/nice/nice-une-femme-de-85-ans-detroussee-et-blessee-a-la-tete-par-une-bande-de-mineurs-20230321,3,6,0,9
1319,1638128128236167168,2023-03-21 10:39:15,NemesisNemesi75,@Teddypwet On est en droit d’attendre de l’État que les 63% d’étrangers qui composent la totalité des agresseurs sexuels dans le métro en IDF soient expulsés. On peut pas le faire nous-mêmes hein.,0,0,0,0
1320,1638126138991026176,2023-03-21 10:31:21,NemesisNemesi75,Le métro parisien va bientôt être doté de la 5G super. Quand est-ce qu’on aura la sécurité dedans par contre ? https://www.lesechos.fr/tech-medias/hightech/le-metro-parisien-va-se-doter-des-premieres-lignes-100-couvertes-en-5g-deurope-1410344,26,114,3,143
1321,1638100381317185536,2023-03-21 08:48:59,NemesisNemesi75,Yvelines : un homme a été mis en examen et placé en détention provisoire. Il est soupçonné d’avoir violé à plusieurs reprises une femme sous la menace d’une arme . https://www.ouest-france.fr/ile-de-france/houilles-78800/yvelines-une-femme-victime-de-viol-dans-une-maison-abandonnee-un-suspect-en-detention-provisoire-39e9814a-c732-11ed-8b34-a52b4ffaa55e,5,18,0,23
1322,1638098507432181761,2023-03-21 08:41:33,NemesisNemesi75,Une femme à Caen sert d’esclave sexuelle à 6 afghans hébergés à nos frais par les services sociaux. La députée @sandrousseau dirait sûrement qu’il vaut mieux garder ces violeurs en France pour pouvoir les surveiller. https://twitter.com/NemesisNemesi75/status/1638098507432181761/video/1,426,651,27,1104
1323,1637782672586993666,2023-03-20 11:46:32,NemesisNemesi75,Assises des Landes : un père de famille de 46 ans jugé pour le viol et des violences sur sa compagne et sa maîtresse. Cette dernière a été violée sous la menace d’un katana alors qu’elle venait de découvrir sa double vie et voulait le quitter. https://www.sudouest.fr/justice/assises-des-landes-juge-pour-le-viol-de-sa-compagne-et-de-sa-maitresse-14487474.php,5,17,0,22
1324,1637781382859575296,2023-03-20 11:41:24,NemesisNemesi75,"Dimanche 19 mars, une femme de 35 ans a été violée en pleine rue en Seine-Saint-Denis, alors qu’elle sortait d’une station de métro pour regagner son domicile.

Une enquête a été ouverte et les policiers recherchent activement le suspect.

https://www.valeursactuelles.com/faits-divers/seine-saint-denis-une-femme-se-fait-violer-en-pleine-rue-par-un-homme-qui-la-suivait",23,43,0,66
1325,1637779978900189184,2023-03-20 11:35:50,NemesisNemesi75,"Ce lundi matin, une femme a été retrouvée égorgée dans un hall d’immeuble du XIIème arrondissement de Paris. Un suspect qui est probablement son compagnon a été interpellé. Selon les premiers éléments, il pourrait s'agir d'un acte prémédité par le suspect. https://actu17.fr/faits-divers/paris-une-femme-meurt-egorgee-un-suspect-interpelle.html",6,23,0,29
1326,1637379117409619968,2023-03-19 09:02:57,NemesisNemesi75,"Les mêmes personnes qui nous font la morale sur l’accueil des migrants ne sont même pas capables d’accueillir… un chaton « CordierAlice2: Vendredi, en sortant des locaux d’un média de droite, nous avons trouvé ce chaton abandonné dans le local à poubelles.

Il est maintenant en sécurité, mais j’aimerai juste rappeler aux voisins qui l’ont abandonné salement que ce sont « les fachos du rdc » qui l’ont récupéré. https://twitter.com/CordierAlice2/status/1637372304802938880/photo/1 — https://twitter.com/cordieralice2/status/1637372304802938880 »",18,106,0,124
1327,1636657705333997568,2023-03-17 09:16:19,NemesisNemesi75,"Merci @MAndrouet de défendre les femmes au sein des plus hautes instances de l’UE. 👊🏻💙. « MAndrouet: Je viens d’être accusée par une collègue danoise ""progressiste"" de propager la haine pour avoir simplement rappelé que le néo-#féminisme d'aujourd'hui était une tragédie pour la cause des femmes. OUI, une femme naît...femme, n'en déplaise à ces ""militant.e.s zélé.e.s"" 🤦‍♀️ ! https://twitter.com/MAndrouet/status/1636097651090358276/video/1 — https://twitter.com/mandrouet/status/1636097651090358276 »",16,62,1,79
1328,1636651388930342915,2023-03-17 08:51:13,NemesisNemesi75,Val-d’Oise :  une policière âgée de 35 ans a été retrouvée morte à son domicile ce jeudi. Son conjoint de la victime a été arrêté et il est suspecté d’homicide. https://amp.lefigaro.fr/faits-divers/val-d-oise-une-policiere-municipale-tuee-son-conjoint-interpelle-20230316?fbclid=PAAaavw4cBxCyXG2SchfdajEhrC_sMM3XmXvq0QYS89dsn_R4QWeyAwAkKVjM,2,9,0,11
1329,1636633852302053376,2023-03-17 07:41:32,NemesisNemesi75,Sources : https://www.cnews.fr/videos/faits-divers/2023-03-13/viol-dune-nonagenaire-son-domicile-lagresseur-avait-deja-sevi-dans-le?amp et https://actu.fr/ile-de-france/clichy_92024/hauts-de-seine-sorti-de-prison-pour-etre-interroge-l-agresseur-saute-par-la-fenetre-du-commissariat_39200860.html,6,16,0,22
1330,1636632128925433857,2023-03-17 07:34:41,NemesisNemesi75,La justice de ce pays est à l’image du ministre de la justice @E_DupondM : elle fait en permanence des bras d’honneur aux victimes.,19,62,2,83
1331,1636632127759368194,2023-03-17 07:34:41,NemesisNemesi75,"Constatant cette réponse pénale quasi inexistante, c’est en toute logique que Walid se permettra un viol et un cambriolage sur une femme de 96 ans quelques temps plus tard.",6,28,1,35
1332,1636632126161395713,2023-03-17 07:34:40,NemesisNemesi75,il récidive avec un racket violent et des violences physiques et sexuelles sur une adolescente de 14 ans pour laquelle rien ne sera fait : la plainte sera classée sans suites.,3,24,1,28
1333,1636632124944990209,2023-03-17 07:34:40,NemesisNemesi75,"Nous avons encore ici un exemple typique du laxisme à la française : auteur d’un cambriolage en juillet 2020, Walid n’a probablement jamais mis un pied en prison puisque, dès septembre 2020,",4,19,2,25
1334,1636632123384774656,2023-03-17 07:34:40,NemesisNemesi75,Il est également connu pour être le co-auteur d’un cambriolage en juillet 2020.,4,16,1,21
1335,1636632122042597376,2023-03-17 07:34:39,NemesisNemesi75,"Ce même Walid E. est aussi le co-auteur d’un violent racket d’un jeune homme de 19 ans, le 12 septembre 2020. Le jeune homme de 19 ans a été traité par ses complices et par Walid de « petit Français », et menacé de mort en cas de plainte auprès de la police.",8,20,1,29
1336,1636632120679362560,2023-03-17 07:34:39,NemesisNemesi75,"Elle ajoute : « Il l’a notamment frappé parce qu’elle refusait de lui donner ma carte bancaire, comme je suis juive, il pensait que j’étais riche. C’est un cas typique des préjugés qui sévissent chez certains jeunes de banlieue ».",6,24,1,31
1337,1636632118905257984,2023-03-17 07:34:38,NemesisNemesi75,"Laetitia, la mère de la jeune victime témoigne : « Il considérait que ma fille était une “pute”, sans doute parce qu’elle n’était pas voilée ».",9,25,1,35
1338,1636632116250173441,2023-03-17 07:34:38,NemesisNemesi75,"[THREAD] Walid E., le suspect du viol d’Huguette (96 ans), violée et cambriolée à Clichy-la-Garenne en février dernier, était déjà connu pour viol sur une ado de 14 ans dans le même immeuble. https://twitter.com/NemesisNemesi75/status/1636632116250173441/photo/1",152,234,7,393
1339,1636617431173963776,2023-03-17 06:36:17,NemesisNemesi75,"À Mulhouse, un clandestin marocain se faisant passer pour un mineur vient d’être condamné à 12 ans de prison pour viols et agressions sexuelles sur plusieurs jeunes femmes, dont une ado de 13 ans https://www.lalsace.fr/faits-divers-justice/2023/03/16/viols-et-agressions-a-mulhouse-douze-ans-de-reclusion",57,93,4,154
1340,1636391515152093186,2023-03-16 15:38:34,NemesisNemesi75,Les françaises ne sont pas et ne seront jamais des frontières violables . https://twitter.com/NemesisNemesi75/status/1636391515152093186/photo/1,29,130,2,161
1341,1636281892654796800,2023-03-16 08:22:58,NemesisNemesi75,"Le 4 août 2019, alors que Chloé venait récupérer leur fils, Ibrahima Ba, séparé de la jeune femme depuis six ans, s'était emparé d'une arme de poing dissimulée dans une bouche d’égout et avait tiré à quatre reprises sur elle, deux tirs dans le thorax, deux dans l'abdomen.",1,5,0,6
1342,1636281891098615811,2023-03-16 08:22:58,NemesisNemesi75,Ibrahima Ba vient d’être condamné à la perpétuité avec une période de sûreté de 22 ans pour avoir tué son ex-compagne alors enceinte de huit mois. https://www.tf1info.fr/amp/justice-faits-divers/aix-en-provence-au-dela-d-un-feminicide-un-homme-condamne-a-la-perpetuite-pour-avoir-tue-son-ex-compagne-enceinte-de-huit-mois-2251090.html,17,48,6,71
1343,1636279109985632257,2023-03-16 08:11:55,NemesisNemesi75,"Dylan avait déjà 8 mentions à son casier et 7 condamnations. Il est fort probable qu’il récidive à sa sortie. 
https://www.actu-juridique.fr/penal/tribunal-de-meaux-jai-eu-tres-peur-de-mourir-peur-pour-mes-enfants/",1,16,0,17
1344,1636279108605714434,2023-03-16 08:11:54,NemesisNemesi75,"Dylan, 26 ans, vient d’être condamné pour la tentative de viol d’une infirmière. À la barre, l’accusé dira « Les faits, je m’en bats les couilles ! Rien à foutre ! De toute façon, je vais prendre perpète… » en réalité, il n’est condamné qu’à 9 ans de prison.",16,64,3,83
1345,1636275553920532481,2023-03-16 07:57:47,NemesisNemesi75,"Abdelaali, un professeur d’anglais algérien de 41 ans arrivé en France sans visa, vient d’être condamné à seulement quatre mois et une interdiction de séjourner en France jusqu’en 2026 pour l’agression sexuelle d’Emma, une étudiante de 20 ans. https://www.actu-juridique.fr/droit-penal/tribunal-de-meaux-elle-etait-a-30-secondes-de-sa-maison-cest-ce-qui-la-sauvee/",22,45,1,68
1346,1636273225624694785,2023-03-16 07:48:32,NemesisNemesi75,https://www.ledauphine.com/faits-divers-justice/2023/03/15/agression-d-une-femme-avec-un-tesson-de-bouteille-a-annemasse-4-ans-et-demi-de-prison-ferme,7,24,0,31
1347,1636273224362147840,2023-03-16 07:48:31,NemesisNemesi75,Annemasse : une jeune femme tabassée à coups de tesson de bouteille par un migrant clandestin libyen. Il a été donné à la victime 16 jours d’ITT et celle-ci a une énorme plaie au visage. La «raison» de cette agression est qu’elle a eu l’audace de refuser ses avances…,127,268,15,410
1348,1636113304014708736,2023-03-15 21:13:03,NemesisNemesi75,"Belgique: un migrant syrien, venant d’obtenir le statut de réfugié politique, a été condamné à 15 ans d’emprisonnement pour avoir violé sa belle-fille de 8 ans , la victime était tombée enceinte de deux jumeaux. 

https://www.fdesouche.com/2023/03/15/doische-belgique-un-syrien-viol-et-met-enceinte-sa-belle-fille-de-8-ans-selon-lui-il-etait-normal-dans-sa-culture-davoir-des-relations-sexuelles-avec-des-mineures-il-vient-do/",17,54,7,78
1349,1636029416072511490,2023-03-15 15:39:43,NemesisNemesi75,https://www.lemonde.fr/societe/article/2023/03/13/deja-mis-en-cause-pour-agression-sexuelle-le-rappeur-moha-la-squale-mis-en-examen-pour-viol_6165299_3224.html,4,10,0,14
1350,1636029413354532866,2023-03-15 15:39:42,NemesisNemesi75,"Moha La Squale (Mohamed Bellahmed, de son vrai nom) déjà mis en cause pour agression sexuelle, a été mis en examen pour viol.  Objet de plaintes de six anciennes compagnes, il a été placé en détention provisoire depuis mi-juin pour non-respect de son contrôle judiciaire. https://twitter.com/NemesisNemesi75/status/1636029413354532866/photo/1",37,115,3,155
1351,1636026317912064003,2023-03-15 15:27:24,NemesisNemesi75,"Jusqu’à vendredi, la cour d’assises du Nord juge Hocine Hamoudi, 35 ans, pour le viol et le meurtre de Sandra, le 1er mai 2015 à Hazebrouck. Le légiste avait compté 144 lésions sur tout le corps. Lorsque les faits se sont produits, elle venait de porter plainte contre lui. https://twitter.com/NemesisNemesi75/status/1636026317912064003/photo/1",12,48,3,63
1352,1635932300453052417,2023-03-15 09:13:49,NemesisNemesi75,"La gauche nous parle toujours des discriminations à l’encontre des minorités mais ne pas vouloir serrer la main d’une femme en raison de son sexe ce n’est pas une discrimination ? Sur cette discrimination criante, on ne l’entend jamais.",36,127,0,163
1353,1635925552015060993,2023-03-15 08:47:00,NemesisNemesi75,« Kate Middleton dans son propre pays a osé tendre la main à un homme : le scandale ». Ce ne serait pas plutôt les musulmans qui ne s’adaptent pas au mode de vie occidental qui commettent des « impairs » plutôt @aufeminin.com ? 🤯🤯🤯 On marche sur la tête là ! https://twitter.com/NemesisNemesi75/status/1635925552015060993/photo/1,230,603,36,869
1354,1635919967605383170,2023-03-15 08:24:48,NemesisNemesi75,"Comme l’a dit très justement Marc Menant dans sa chronique sur @CNEWS : on nous tanne avec la creolisation, la mixité serait FORMIDABLE et on y gagnerait tous. Mais qu’y gagnent les femmes là-dedans à part être dans la soumission et d’être moins bien considérées ? https://twitter.com/NemesisNemesi75/status/1635919967605383170/video/1",60,168,1,229
1355,1635696548783828999,2023-03-14 17:37:01,NemesisNemesi75,@NoelDamien @francois_ozon Il est vrai qu’on a aussi plus l’habitude de voir Lucchini dans ce genre de rôle (et il est lui même souvent très théâtral voir cabotin),0,0,1,1
1356,1635692416765243418,2023-03-14 17:20:36,NemesisNemesi75,"@GuiseHenri @CordierAlice2 @francois_ozon On vous conseille d’aller le voir sans aprioris pour vous faire un avis mar vous-même ;) Ceci dit , qu’il y ai le terme « égalité » dans un film se situant dans les années 30 et parlant d’une tentative de viol par un producteur ne nous paraît pas vraiment ultra neo féministe 🤷🏻‍♀️",0,0,1,1
1357,1635681234989854736,2023-03-14 16:36:10,NemesisNemesi75,"[CINEMESIS] 🎬Cette semaine, ne loupez pas la nouvelle comédie de @francois_ozon au cinéma ! Si vous l’avez déjà vue, qu’en avez-vous pensé ? Nous on a adoré ! Notre avis ici : https://youtube.com/watch?v=-NqRKESNdkg&si=EnSIkaIECMiOmarE https://twitter.com/NemesisNemesi75/status/1635681234989854736/photo/1",14,39,3,56
1358,1635544097875173378,2023-03-14 07:31:14,NemesisNemesi75,C’est sûrement à cause de la culture judéo-chrétienne https://www.lemonde.fr/asie-pacifique/article/2018/09/14/37-des-femmes-qui-se-suicident-dans-le-monde-sont-indiennes_5355248_3216.html,24,113,2,139
1359,1634542835742519299,2023-03-11 13:12:35,NemesisNemesi75,"Baba Bambara condamné à 20 ans de réclusion criminelle pour le meurtre de sa femme Eliane.
https://www.ladepeche.fr/2023/03/10/femme-tuee-par-son-conjoint-de-27-coups-de-couteau-a-toulouse-baba-bambara-condamne-a-20-ans-de-reclusion-criminelle-11053245.php",8,15,2,25
1360,1634490843078746112,2023-03-11 09:45:59,NemesisNemesi75,"Et dans le milieu du théâtre et du cinema @AndreaBescond , vous n’avez pas les mêmes exigences visiblement ? 🙃 https://twitter.com/NemesisNemesi75/status/1634490843078746112/photo/1",19,96,3,118
1361,1634481077694636033,2023-03-11 09:07:10,NemesisNemesi75,Une femme sans-abri a été violée et frappée dimanche 5 mars 2023 dans une rue de Sète dans l’Hérault. Son compagnon aurait été filmé en train de l’agresser. L’homme de 46 ans a été mis en examen puis placé en détention provisoire. https://www.ouest-france.fr/region-occitanie/sete-34200/une-sans-abri-victime-dun-viol-dans-la-rue-a-sete-son-compagnon-mis-en-examen-96f46c00-bf4f-11ed-b397-b1fbc9f24a88,18,22,0,40
1362,1634480165114855425,2023-03-11 09:03:33,NemesisNemesi75,Stéphane Jourdan condamné à 10 ans de réclusion criminelle pour un viol commis dans la soirée du 1er août 2020.          L’avocat général avait requis 13 ans de réclusion criminelle et 10 ans de suivi socio-judiciaire. https://www.ladepeche.fr/amp/2023/03/10/assises-du-tarn-stephane-jourdan-condamne-a-10-ans-de-reclusion-criminelle-pour-viol-11052861.php,4,7,1,12
1363,1634478724430065665,2023-03-11 08:57:49,NemesisNemesi75,"À Clichy-la-Garenne, Walid E., déjà connu des services de police pour des faits d’agression sexuelle sur mineure, a été interpellé pour le viol d’une femme de 96 ans, malentendante. Il en a aussi profité pour la cambrioler. 

https://actu.orange.fr/societe/videos/clichy-la-garenne-une-femme-de-96-ans-malentendante-a-ete-cambriolee-et-violee-le-suspect-walid-20-ans-etait-deja-connu-pour-agression-sexuelle-sur-mineure-CNT0000020H86R.html",22,33,4,59
1364,1634477265542082560,2023-03-11 08:52:01,NemesisNemesi75,"À Mende (Lozère) une jeune femme de 19 ans a été violée à son domicile par un migrant afghan, qui s’est introduit de force chez elle. Le suspect a été mis en examen puis laissé libre sous contrôle judiciaire. https://actu17.fr/faits-divers/mende-un-demandeur-dasile-afghan-mis-en-examen-pour-le-viol-dune-jeune-femme.html",43,97,15,155
1365,1634476081397768192,2023-03-11 08:47:19,NemesisNemesi75,"Poitiers : Lundi 6 mars, un réfugié érythréen a été écroué après avoir défenestré sa femme enceinte de 5 mois, elle aussi de nationalité érythréenne, du 5e étage. https://www.valeursactuelles.com/regions/nouvelle-aquitaine/vienne/poitiers/faits-divers/poitiers-un-refugie-erythreen-ecroue-apres-avoir-defenestre-sa-femme-enceinte-du-5e-etage",18,27,1,46
1366,1634249356445351936,2023-03-10 17:46:24,NemesisNemesi75,"Le 7 février dernier, lors de la première prise de parole d’@AQuatennens devant l’Assemblée Nationale depuis sa condamnation, celui-ci a été applaudi par des députés de la France insoumise, montrant ainsi que la @FiAssemblee n’en a jamais terminé avec l’indécence.",1,22,0,23
1367,1634249352808996864,2023-03-10 17:46:23,NemesisNemesi75,"Le 8 mars, journée internationale des droits des femmes, des militantes du Collectif Nemesis se sont rendues devant les locaux de LFI pour exprimer le fait que l’immense majorité des Français (67%) souhaitent la démission d’@AQuatennens , condamné pour violences conjugales. https://twitter.com/NemesisNemesi75/status/1634249352808996864/video/1",18,87,1,106
1368,1634137363185123332,2023-03-10 10:21:22,NemesisNemesi75,"Ce jeudi, Nadège, une femme de 48 ans a été tuée de plusieurs coups de couteau par son ex-conjoint sous les yeux de sa fille de 12 ans. https://www.lavoixdunord.fr/1300642/article/2023-03-09/bethune-une-femme-tuee-par-son-ex-conjoint-sous-les-yeux-de-sa-fille",25,46,4,75
1369,1633887737009848323,2023-03-09 17:49:27,NemesisNemesi75,Quelque chose se prépare… #Quatennens https://twitter.com/NemesisNemesi75/status/1633887737009848323/photo/1,22,119,4,145
1370,1633515134613159941,2023-03-08 17:08:51,NemesisNemesi75,"Cathédrale incendiée, prêtre assassiné par un Rwandais et aujourd'hui des religieuses sont obligées de quitter la ville parce qu'elles craignent pour leurs vies. 

La question est simple : que faut-il qu'il se passe à #Nantes pour qu'enfin la maire et ses adjoints réagissent ? https://twitter.com/NemesisNemesi75/status/1633515134613159941/photo/1",148,276,17,441
1371,1633422311259873281,2023-03-08 11:00:01,NemesisNemesi75,"Et nous savons très bien aussi, qu’un droit n’est jamais complètement acquis. 
Restons donc toujours vigilantes et attentives face à toutes les forces qui souhaiteraient les voir reculer !",2,13,1,16
1372,1633422309582053378,2023-03-08 11:00:00,NemesisNemesi75,"En droit, l’égalité est donc atteinte. Mais dans les faits, pas toujours: les femmes sont toujours davantage victimes de violences sexuelles ou conjugales.",3,14,1,18
1373,1633422308118343680,2023-03-08 11:00:00,NemesisNemesi75,"L’égalité en France entre femmes et hommes est inscrite dans le préambule de la Constitution depuis le 27 octobre 1946: ""La loi garantit à la femme, dans tous les domaines, des droits égaux à ceux de l'homme.""",1,15,1,17
1374,1633422305605955584,2023-03-08 10:59:59,NemesisNemesi75,"La journée des droits des femmes est l’occasion de se remémorer nos  victoires mais aussi le chemin qui reste à parcourir.
#journeeinternationaledesdroitsdesfemmes #internationalwomensday #8mars https://twitter.com/NemesisNemesi75/status/1633422305605955584/photo/1",23,81,3,107
1375,1633388598706814977,2023-03-08 08:46:03,NemesisNemesi75,Le détail des votes ici : https://www2.assemblee-nationale.fr/scrutins/detail/(legislature)/16/(num)/1128#G1,8,22,1,31
1376,1633388273375625216,2023-03-08 08:44:45,NemesisNemesi75,"- @sandrousseau s’abstient.
- @Deputee_Obono et @MathildePanot votent carrément contre. 🤡         

Voilà le cadeau que font les féministes les plus célèbres de l’hémicycle aux femmes la veille du #8mars, journée internationale des droits des femmes.🙃 #lahonte",58,150,6,214
1377,1633388271664259094,2023-03-08 08:44:45,NemesisNemesi75,"Concernant la proposition de loi visant à étendre la peine complémentaire obligatoire d'inéligibilité à une série de violences aggravées, dont celles sur conjoint :",25,63,2,90
1378,1633374764914884609,2023-03-08 07:51:05,NemesisNemesi75,"“C’est pas méchant, on a tous déjà touché des filles” explique Abdel Bouhazama, entraîneur du SCO d’Angers en voulant soutenir Ilyes Chetti, joueur latéral, mis en cause pour agression sexuelle. https://www.leparisien.fr/sports/ligue-1-on-a-tous-deja-touche-des-filles-les-propos-deplaces-du-coach-dangers-avant-le-match-a-montpellier-07-03-2023-DYP5GLCPIFETPEMMCY5PT6M36A.php https://twitter.com/NemesisNemesi75/status/1633374764914884609/photo/1",33,62,6,101
1379,1633014734197800960,2023-03-07 08:00:27,NemesisNemesi75,"Nous ne jugeons pas le choix de cette victime à vouloir en finir avec la vie. Mais sans argent ni aides pour pouvoir se soigner dans un hôpital, l’euthanasie est-elle vraiment un choix où est-ce la seule solution proposée par le gouvernement belge à cette mère de famille ?",10,44,4,58
1380,1633014732641775616,2023-03-07 08:00:26,NemesisNemesi75,Le fils de Nathalie souligne que ces 2000 euros ne représente qu’une infime partie des coûts totaux que sa famille ont déjà dû payer pour des thérapies.,2,15,1,18
1381,1633014731098267651,2023-03-07 08:00:26,NemesisNemesi75,"Un expert judiciaire a estimé que le préjudice physique et mental de sa mère s’élevait à 2.000 euros seulement pour l’auteur de l’infraction. Évidemment, l’agresseur ne peut pas payer et ne lui a versé que 60 euros. Le comble : la responsabilité a été transférée à la victime.",2,17,2,21
1382,1633014729655427073,2023-03-07 08:00:26,NemesisNemesi75,Le fils de Nathalie explique aussi que sa mère n’a plus assez d’argent pour pouvoir se faire soigner en hôpital psychiatrique. https://www.7sur7.be/belgique/nathalie-a-ete-violee-alors-quelle-faisait-son-footing-la-demande-d-euthanasie-commence-a-rendre-sa-fin-tres-reelle-br~af1739cd/,4,12,1,17
1383,1633014728069881856,2023-03-07 08:00:25,NemesisNemesi75,Je lui ai dit qu'il avait réussi à transformer quelqu'un qui aimait tant vivre et était si heureux en quelqu'un qui ne voulait plus vivre. https://m-nieuwsblad-be.translate.goog/cnt/dmf20220224_95686492?_x_tr_sl=auto&_x_tr_tl=fr&_x_tr_hl=fr&_x_tr_pto=wapp,2,9,1,12
1384,1633014726631325697,2023-03-07 08:00:25,NemesisNemesi75,"Nathalie rendra visite à l’agresseur en prison : «Je l'ai confronté à toutes les conséquences qu'il m'a faites. Je lui ai dit ce que je ressentais. À quel point il m'a dévasté, moi et ma famille.",2,11,2,15
1385,1633014725129666560,2023-03-07 08:00:25,NemesisNemesi75,"Dans un témoignage, le fils de Nathalie nous apprend qu’après seulement 5 ans de détention (soit un tiers de la peine), l’agresseur peut bénéficier d’une libération anticipée grâce à la loi Lejeune. Heureusement, cette demande a été rejetée.",2,15,1,18
1386,1633014723632349186,2023-03-07 08:00:24,NemesisNemesi75,"Mais l’horreur n’est pas terminée, et le coup de grâce, c’est la justice belge qui va le donner : l’agresseur fait appel de cette décision. En appel au lieu des 19 ans initialement donné, il écope finalement de 15 ans seulement.",3,15,1,19
1387,1633014722298560512,2023-03-07 08:00:24,NemesisNemesi75,Il sera condamné à 19 ans de prison : 15 ans pour Nathalie et 4 ans pour des violences sur son ex-compagne.,2,13,1,16
1388,1633014720788590593,2023-03-07 08:00:24,NemesisNemesi75,"Au début, l’agresseur est introuvable, mais au bout de 14 mois, il est enfin attrapé. Il venait de se faire expulser de chez lui par sa compagne. Les faits ont été décrits lors du procès comme ""l’un des viols les plus horribles jamais commis dans notre pays.""",4,15,1,20
1389,1633014718985125888,2023-03-07 08:00:23,NemesisNemesi75,"Quatre mois après le viol, elle fait une première tentative de suicide et une première admission en psychiatrie. Nathalie souffre de séquelles physiques : cela fait des mois qu’elle ne peut plus manger de nourriture solide. https://www.midilibre.fr/amp/2023/03/01/sauvagement-violee-et-detruite-psychologiquement-nathalie-pourra-etre-euthanasiee-en-belgique-11030466.php",2,9,2,13
1390,1633014717382795266,2023-03-07 08:00:23,NemesisNemesi75,"Nous apprenons par son fils que l’auteur a le même âge que la victime et s’appelle Pascal P. 
https://www.7sur7.be/belgique/nathalie-a-ete-violee-alors-quelle-faisait-son-footing-la-demande-d-euthanasie-commence-a-rendre-sa-fin-tres-reelle-br~af1739cd/",4,12,1,17
1391,1633014715096989697,2023-03-07 08:00:22,NemesisNemesi75,"« Je vois un visage noir de colère (…) À ce moment-là, il m’attrape et je vois ses yeux noirs agressifs. Il est furieux et me jette dans le fossé avec une force énorme. » Voici le témoignage de Nathalie à lire en intégralité ici :https://www.7sur7.be/belgique/victime-d-un-viol-une-mere-obtient-le-feu-vert-pour-l-euthanasie-la-nathalie-que-j-etais-est-morte-ce-matin-la~a646fe4c/ https://twitter.com/NemesisNemesi75/status/1633014715096989697/photo/1",3,11,1,15
1392,1633014710109970432,2023-03-07 08:00:21,NemesisNemesi75,"En 2016, Nathalie a été sauvagement agressée et violée alors qu’elle faisait son footing. Son agresseur la frappe à plusieurs reprises, au point de lui briser la mâchoire. S'ensuivent des viols à plusieurs reprises sous la menace d’un couteau, elle est laissée pour morte. https://twitter.com/NemesisNemesi75/status/1633014710109970432/photo/1",9,40,6,55
1393,1633014704875483138,2023-03-07 08:00:20,NemesisNemesi75,"Victime de viol en 2016, cette mère de famille vient d’obtenir l’accord de médecins pour être euthanasiée en Belgique. Son histoire est bouleversante. https://twitter.com/NemesisNemesi75/status/1633014704875483138/photo/1",9,43,7,59
1394,1633014699485810689,2023-03-07 08:00:18,NemesisNemesi75,"[THREAD] L’histoire de Nathalie est d’une tristesse infinie. Nôtre rôle n’est pas d’avoir un avis sur l’euthanasie mais de dénoncer les violences faites aux femmes et le laxisme de la réponse pénale qui sévit aussi chez nos amis et voisins belges.🇧🇪 
https://amp.lepoint.fr/2511005 https://twitter.com/NemesisNemesi75/status/1633014699485810689/photo/1",54,121,4,179
1395,1632984966618292260,2023-03-07 06:02:10,NemesisNemesi75,@XemoxLeKokiri Ok on y pensera alors pour les Jean premier degré fans d’animes,0,4,2,6
1396,1632976644905357312,2023-03-07 05:29:06,NemesisNemesi75,@XemoxLeKokiri @AntoineGoya Et que ne comprends-tu pas dans les propos ironiques d’une de nos porte-parole ?,0,3,1,4
1397,1632970780815372291,2023-03-07 05:05:47,NemesisNemesi75,"@XemoxLeKokiri @AntoineGoya Ok, d’accord.
Et les preuves est ce qu’elles sont avec nous dans cette pièce en ce moment ? https://twitter.com/NemesisNemesi75/status/1632970780815372291/photo/1",0,4,1,5
1398,1632967111206158337,2023-03-07 04:51:13,NemesisNemesi75,@XemoxLeKokiri @AntoineGoya Merde… Je suis la CM pourquoi je suis jamais invitée à ces fameuses « parties fines » ? C’est vexant à la fin,0,5,1,6
1399,1632718476543508482,2023-03-06 12:23:13,NemesisNemesi75,"Témoignage poignant de Riley Gaines, une nageuse américaine. Elle explique qu’en plus de devoir partager les podiums avec un homme dans sa discipline, elle et ses coéquipières sont aussi forcées par la fédération de partager leurs vestiaires avec lui  … https://youtube.com/watch?v=62QGGDdsytM&si=EnSIkaIECMiOmarE",66,135,8,209
1400,1632677887185698816,2023-03-06 09:41:56,NemesisNemesi75,"Sources :

https://kvinfo.dk/wp-content/uploads/2020/05/Tonic-immobility-during-sexual-assault.pdf

https://www.ined.fr/fichier/s_rubrique/30810/dossier_presse_virage_final.fr.pdf",5,17,3,25
1401,1632677882374807554,2023-03-06 09:41:55,NemesisNemesi75,Un travail plus rigoureux qu’une simple conviction personnelle est nécessaire pour traiter ce genre de sujet @HommesInfluence,5,34,1,40
1402,1632677878067339264,2023-03-06 09:41:54,NemesisNemesi75,"Donc @HommesInfluence , vous vous prétendez sociologue mais quelles sont vos sources pour affirmer des énormités pareilles démontrables en quelques études (et surtout avec pas mal de bon sens) ? Pourquoi faire payer aussi cher des formations aussi peu crédibles ?",8,59,1,68
1403,1632677872904151040,2023-03-06 09:41:53,NemesisNemesi75,Sans parler des viols commis avec l’aide d’une drogue type GHB. Les victimes n’en seraient donc pas vraiment puisqu’elles ne se sont pas débattues ?,5,42,2,49
1404,1632677867829043207,2023-03-06 09:41:52,NemesisNemesi75,"Ce phénomène bien connu s’appelle la sidération traumatique, et n’est pas observée uniquement chez les femmes mais aussi chez les hommes. Et pas seulement dans les cas de viols mais aussi dans les cas d’attaques terroristes ou dans n’importe quel type d’agressions.",13,94,1,108
1405,1632677859180310534,2023-03-06 09:41:49,NemesisNemesi75,Dans la majorité des cas il n’y a eu aucun usage de la force puisqu’une étude de 2017 nous apprend que 68% des victimes de viol ont été totalement paralysées.,10,65,3,78
1406,1632677850917511169,2023-03-06 09:41:48,NemesisNemesi75,"Le viol brutal, commis tel qu’on l’imagine par un inconnu avec un couteau dans la rue est certes spectaculaire (et malheureusement de plus en plus fréquent) mais il reste minoritaire.",9,53,2,64
1407,1632677845741830144,2023-03-06 09:41:46,NemesisNemesi75,"Rappel : la majorité des viols sont commis dans l’environnement familial (parents et famille proche) et 80% d’entre eux sont commis par des proches de la victime (donc famille et amis). L'auteur le plus fréquent, tant chez les victimes féminines que masculines, est un oncle.",14,74,1,89
1408,1632677839374897154,2023-03-06 09:41:45,NemesisNemesi75,Le YouTubeur @HommesInfluence a lancé une série de conférences payantes à hauteur de 200€ où nous retrouvons notamment le passage suivant : «le viol d’une femme est impossible sans l’usage de la force.» https://twitter.com/NemesisNemesi75/status/1632677839374897154/video/1,78,247,36,361
1409,1632384857014714368,2023-03-05 14:17:32,NemesisNemesi75,"Nous avons une question à poser à Violaine De Filippis : en tant que femme, dans quel pays de culture non judéo-chrétienne trouverais-tu de meilleures conditions ? La lutte pour le droit des femmes est issue du monde judéo-chrétien. Vous avez deux heures :)",25,120,5,150
1410,1632384849926397953,2023-03-05 14:17:31,NemesisNemesi75,Les militantes d’@osezlefeminisme sont beaucoup plus promptes à stigmatiser la culture judéo-chrétienne qu’à évoquer la culture musulmane comme nous avions pu le voir lors de l’affaire Mila pour laquelle Alyssa Ahrabare n’avait souhaité s’exprimer sur @RMCInfo https://twitter.com/NemesisNemesi75/status/1632384849926397953/video/1,53,170,10,233
1411,1632370504051957760,2023-03-05 13:20:30,NemesisNemesi75,Nous avons acceptées de rencontrer @CNEWS pour leur faire part de l’insécurité que nous ressentons dans la rue mais aussi de plus en plus dans les bars et boîtes de nuit de la capitale. https://twitter.com/NemesisNemesi75/status/1632370504051957760/video/1,177,394,24,595
1412,1631992717998694402,2023-03-04 12:19:19,NemesisNemesi75,https://www.lefigaro.fr/vox/monde/tous-les-etats-doivent-condamner-la-gpa-et-adopter-des-mesures-pour-la-combattre-20230302,9,41,2,52
1413,1631926436247240706,2023-03-04 07:55:56,NemesisNemesi75,Nous réitérons donc : ces 100 000€ seraient bien mieux dépensés dans la sécurité de la ville dont Paris manque cruellement.,7,31,1,39
1414,1631926398423113729,2023-03-04 07:55:47,NemesisNemesi75,"Pour rappel, en décembre dernier, nous avions manifesté devant la mairie de Paris pour dénoncer le soutien de la ville à cette ONG pro-migrants, rappelant au passage à Anne Hidalgo que l’argent des parisiens devait servir aux Parisiens, et pas à encourager l’immigration. https://twitter.com/NemesisNemesi75/status/1631926398423113729/photo/1",19,82,2,103
1415,1631924056210456577,2023-03-04 07:46:29,NemesisNemesi75,⚠️BONNE NOUVELLE ⚠️: La justice annule la subvention de 100 000 euros de la mairie de Paris à SOS Méditerranée. La Cour administrative d'appel de Paris a jugé que la mairie avait interféré avec la politique étrangère de la France.                       https://amp.lefigaro.fr/flash-actu/la-justice-annule-une-subvention-de-la-mairie-de-paris-a-sos-mediterranee-20230303,24,133,4,161
1416,1631922564518801410,2023-03-04 07:40:33,NemesisNemesi75,"Seulement un an de prison Matheus Branquinho, un ex-député suppléant LREM de la Loire reconnu coupable d'agressions sexuelles sur deux fillettes de six et huit ans et de détention d'images pédopornographiques.
https://www.lefigaro.fr/faits-divers/pedocriminalite-un-an-de-prison-pour-un-ex-depute-suppleant-lrem-de-la-loire-20230227 https://twitter.com/NemesisNemesi75/status/1631922564518801410/photo/1",59,129,11,199
1417,1631921779223429120,2023-03-04 07:37:26,NemesisNemesi75,"Strasbourg : une ado de 15 ans agressée sexuellement dans le tram par un migrant afghan de 24 ans, ayant “fui les talibans”. Il a été condamné à un an de prison ferme et d’une interdiction du territoire français pendant cinq ans. https://www.20minutes.fr/justice/4026036-20230302-strasbourg-homme-condamne-agression-sexuelle-tram",22,70,7,99
1418,1631920398949310465,2023-03-04 07:31:57,NemesisNemesi75,"“Je ne savais pas que toucher les seins était interdit en France” : à Redon, un demandeur d’asile afghan condamné à 1 an ferme pour avoir agressé sexuellement une jeune femme autiste lors d’un fest-noz (fête bretonne). https://www.ouest-france.fr/bretagne/redon-35600/il-agresse-sexuellement-une-personne-autiste-lors-d-un-fest-noz-a-redon-dd3f337a-b6c6-11ed-8162-65d84108a21b",36,99,10,145
1419,1631912427230044161,2023-03-04 07:00:16,NemesisNemesi75,"Un groupe de jeunes passants est parvenu à plaquer l'agresseur au sol jusqu'à l'arrivée de la police 

La jeune fille, qui était en visite chez ses grands-parents en Suède, avait été hospitalisée jeudi dans un état «grave mais stable», selon la police.",9,50,2,61
1420,1631912423966867458,2023-03-04 07:00:15,NemesisNemesi75,"À Göteborg en Suède, une jeune fille de 10 ans a été poignardée par Milad Salari, un multirécidiviste d’origine iranienne qui a commis 52 crimes depuis son arrivée en Suède en 2002. Lors de l’attaque, cet homme de 36 ans aurait crié “Allah Akbar”. https://twitter.com/NemesisNemesi75/status/1631912423966867458/video/1",84,162,15,261
1421,1631579259067047937,2023-03-03 08:56:23,NemesisNemesi75,"Une fillette de 11 ans violée par une bande d’adolescents à Sarcelles.Âgés de 14 à 15 ans, les garçons qui ont partiellement reconnu les faits seront jugés pour viol en réunion. https://www.bfmtv.com/amp/police-justice/ils-baissent-leur-pantalon-les-autres-surveillent-une-enfant-de-11-ans-violee-par-des-adolescents-a-sarcelles_AN-202303020698.html",68,95,8,171
1422,1631337030041968643,2023-03-02 16:53:51,NemesisNemesi75,https://www.nicematin.com/amp/vie-associative/une-association-daide-aux-victimes-de-violences-conjugales-periclite-faute-de-subventions-a-nice-829743,1,8,0,9
1423,1631337027215007751,2023-03-02 16:53:50,NemesisNemesi75,"À Nice une asso accueillant des victimes de violences conjugales va devoir fermer faute de subventions. Par contre, quand il faut de l’argent pour l’asso pro-migrants ""Les Amis de la Roya"", là, le Conseil départemental du 06 dirigé par Charles-Ange Ginésy (LR) répond présent… https://twitter.com/NemesisNemesi75/status/1631337027215007751/photo/1",241,332,8,581
1424,1630848698870554624,2023-03-01 08:33:24,NemesisNemesi75,https://www.leprogres.fr/faits-divers-justice/2023/02/27/un-homme-juge-pour-la-quatrieme-fois-aux-assises-pour-un-viol-en-2012,4,6,1,11
1425,1630848697121624070,2023-03-01 08:33:23,NemesisNemesi75,"Abdelkrim Mouina sera jugé pour la 4eme fois aux assises pour un viol datant de 2012. Il avait été condamné une première fois en 2018. Jugé ensuite en appel, il s'était alors pourvu en cassation avant d'être de nouveau jugé. Le troisième verdict avait encore une fois été annulé.",19,38,2,59
1426,1630846548354510849,2023-03-01 08:24:51,NemesisNemesi75,Théo a donc décidé de la tuer et s'est rendu dans sa chambre pendant la nuit avec son oreiller et a étouffé à mort la jeune femme.,2,10,0,12
1427,1630846546542571521,2023-03-01 08:24:51,NemesisNemesi75,"Cette jeune femme de 29 ans était internée à l’hôpital Laborit de Nieuil-l’Espoir où elle entretenait une relation amicale avec Théo, mais ce dernier voulait plus qu'une amitié et Jessica a eu le malheur de refuser…",2,12,1,15
1428,1630846544273371141,2023-03-01 08:24:50,NemesisNemesi75,"Théo Hugonnet est condamné à 17 ans de prison pour le meurtre de Jessica Allin en 2019. 

https://france3-regions.francetvinfo.fr/nouvelle-aquitaine/vienne/poitiers/meurtre-au-centre-psychiatrique-de-nieuil-l-espoir-theo-hugonnet-condamne-a-17-ans-de-prison-2722538.htm https://twitter.com/NemesisNemesi75/status/1630846544273371141/photo/1",9,33,2,44
1429,1630599668521418753,2023-02-28 16:03:50,NemesisNemesi75,Saint-Étienne : une femme violée en rentrant chez elle par un tunisien en France depuis 2 mois. https://actu.fr/auvergne-rhone-alpes/saint-etienne_42218/saint-etienne-une-femme-violee-en-rentrant-chez-elle-un-suspect-arrete_57685988.html,17,31,0,48
1430,1630598457382641664,2023-02-28 15:59:01,NemesisNemesi75,"Achraf Hakimi, le latéral droit du Paris Saint-Germain visé par une enquête pour viol. La victime présumée aurait refusé de porter plainte, mais le parquet s’est autosaisi de l’affaire. https://www.leparisien.fr/amp/paris-75/psg-achraf-hakimi-vise-par-une-enquete-pour-viol-27-02-2023-EBER5E5DGFB6BN253XDKKZFD3Y.php",12,27,1,40
1431,1630129953491615745,2023-02-27 08:57:21,NemesisNemesi75,"Ce jeudi, une femme de 21 ans a été poignardée dans le 7e arrondissement de Lyon. Son ex-compagnon est toujours recherché. https://www.lyonmag.com/article/128676/lyon-une-femme-poignardee-son-ex-compagnon-recherche",3,7,1,11
1432,1630119215280578560,2023-02-27 08:14:41,NemesisNemesi75,"Depuis, les ambassades du Mali, du Congo et du Burkina-Faso proposent à leurs ressortissants un retour au pays et leur recommandent de bien se comporter. La Tunisie réussit en 3 jours là où nous échouons depuis 40 ans. Encore une fois, tout est question de volonté politique.",62,259,6,327
1433,1630119213254754304,2023-02-27 08:14:41,NemesisNemesi75,"Suite aux propos du président tunisien dénonçant ""Des hordes de migrants clandestins"" à l'origine de ""violences et d'actes inacceptables"", ""un plan criminel pour changer la composition du paysage démographique en Tunisie"", voici le genre de propos que nous voyons apparaître : https://twitter.com/NemesisNemesi75/status/1630119213254754304/photo/1",153,455,11,619
1434,1629511681020706819,2023-02-25 16:00:34,NemesisNemesi75,https://amp.lefigaro.fr/faits-divers/jusqu-a-70-messages-par-jour-un-homme-accuse-d-avoir-cyberharcele-sandrine-rousseau-bientot-juge-20230225,0,2,0,2
1435,1629511679145918467,2023-02-25 16:00:33,NemesisNemesi75,Un quadragénaire accusé d'avoir cyberharcelé la députée écologiste Sandrine Rousseau a été placé sous contrôle judiciaire vendredi dans l'attente de son procès le 29 mars à Marseille. Il avait déjà été condamné en 2018 dans une autre affaire de harcèlement sur une Youtubeuse.,9,49,5,63
1436,1629179437311729665,2023-02-24 18:00:21,NemesisNemesi75,"Corps d’Assia retrouvé démembré aux Buttes-Chaumont : Youcef Matoug , le mari, est passé aux aveux a reconnu être à l’origine de la mort de sa femme. Il a justifié son acte en disant qu’il existait des rancœurs au sein du couple depuis plusieurs années. https://m.20minutes.fr/amp/a/4025315 https://twitter.com/NemesisNemesi75/status/1629179437311729665/photo/1",93,148,22,263
1437,1629059418909249537,2023-02-24 10:03:26,NemesisNemesi75,"La victime est trop traumatisée pour retourner à l'école. Des sources proches de l’enquête ont déclaré au Times qu’un garçon aurait violé l’écolière tandis que trois autres garçons auraient fait office de “guetteurs”.

https://www-dailymail-co-uk.translate.goog/news/article-11743265/Teenage-asylum-seekers-arrested-connection-alleged-rape-girl-15-school-Kent.html?_x_tr_sl=en&_x_tr_tl=fr&_x_tr_hl=fr&_x_tr_pto=wapp",14,65,1,80
1438,1629059415683866627,2023-02-24 10:03:25,NemesisNemesi75,"Suite au viol présumé d’une collégienne de 15 ans dans une école du Kent par quatre mineurs non accompagnés afghans, des écolières ont manifesté à Douvres pour exprimer leur colère. Tout ce qu’a fait l’école c’est une assemblée pour leur parler de leur façon de s’habiller. #Dover https://twitter.com/NemesisNemesi75/status/1629059415683866627/video/1",296,635,13,944
1439,1628773489816600578,2023-02-23 15:07:15,NemesisNemesi75,Marche aussi pour tout un tas d’autres sujets. 🙃#Palmadegate https://twitter.com/NemesisNemesi75/status/1628773489816600578/video/1,11,41,3,55
1440,1628763497034137600,2023-02-23 14:27:33,NemesisNemesi75,"- d’après les chiffres du Haut-Commissariat des Nations unies pour les réfugiés, 69 % des migrants ayant traversé la Méditerranée pour venir en Europe en 2015 étaient des hommes. 

- 90% des OQTF ne sont pas exécutées.",6,24,0,30
1441,1628763495624765441,2023-02-23 14:27:32,NemesisNemesi75,Évidemment ce sont des questions rhétorique puisque nous savons que :,1,9,1,11
1442,1628763493737324545,2023-02-23 14:27:32,NemesisNemesi75,"Malheureusement ces statistiques ne nous apprennent pas :

- la proportion d’hommes/femmes dans ces demandes 

- que deviennent les 60% de deboutés du droit d’asile.",3,8,1,12
1443,1628763491279437825,2023-02-23 14:27:31,NemesisNemesi75,"En revanche il est très bas pour les ressortissants d’Inde, de Moldavie, de Macédoine du Nord et du Vietnam (1 %), de Tunisie et de Bosnie-Herzégovine (2 %), du Venezuela, de Serbie et du Népal (3 %).",1,4,2,7
1444,1628763489740156929,2023-02-23 14:27:31,NemesisNemesi75,"Ce taux est particulièrement haut pour les Syriens (94 %), les Bélarusses (88 %), les Ukrainiens (86 %), les Erythréens et les Yéménites (84 % chacun), les Maliens (70 %).",1,7,1,9
1445,1628763488100270091,2023-02-23 14:27:31,NemesisNemesi75,"Quelque 40 % des décisions rendues en première instance en 2022 étaient positives - accordant au requérant un statut de réfugié ou de protection subsidiaire -, soit le «taux de reconnaissance» le plus élevé depuis cinq ans.",1,4,1,6
1446,1628763486695170049,2023-02-23 14:27:30,NemesisNemesi75,"Les Vénézuéliens (51 000 demandes) et les Colombiens (43 000), qui n’ont pas besoin de visa pour entrer dans l’espace européen, ont déposé trois fois plus de demandes qu’en 2021. Viennent ensuite les Pakistanais (37 000), les Bangladais (34 000), les Géorgiens (29 000).",2,5,1,8
1447,1628763485311049728,2023-02-23 14:27:30,NemesisNemesi75,"➡️Dans l’ensemble, les Syriens (132 000) et les Afghans (129 000) restent de loin les premiers demandeurs de protection, suivis des Turcs (55 000).",1,4,1,6
1448,1628763483838767104,2023-02-23 14:27:30,NemesisNemesi75,"➡️Ces demandes, principalement déposées par des Syriens et des Afghans, sont en hausse de plus de 50 % par rapport à 2021.

➡️Les demandes d’asile présentées par des mineurs non accompagnés se sont élevées à 43 000 en 2022, soit le plus grand nombre depuis 2015.",3,13,1,17
1449,1628763481217372160,2023-02-23 14:27:29,NemesisNemesi75,THREAD : Selon des données publiées ce mercredi par l’Agence de l’UE pour l’asile (AUEA). Un record depuis 2016 au moment de la crise des réfugiés. https://twitter.com/NemesisNemesi75/status/1628763481217372160/photo/1,31,46,1,78
1450,1628682385624641539,2023-02-23 09:05:14,NemesisNemesi75,"L’adolescent qui a empêché le viol d’une collégienne à Cenon a été retrouvé. Il a 15 ans et se prénomme Idriss. D’ici quelques jours, « des félicitations dignes de ce nom seront organisées », indique la police. Bravo à lui. https://www.sudouest.fr/gironde/cenon/gironde-l-adolescent-qui-a-empeche-un-viol-a-ete-retrouve-et-va-etre-felicite-14165786.php",26,128,3,157
1451,1628411489055920128,2023-02-22 15:08:48,NemesisNemesi75,"💙Simone Segouin, la dernière résistante d'Eure-et-Loir, s'est éteinte ce mardi matin à l’age de 97 ans. 💙 https://twitter.com/NemesisNemesi75/status/1628411489055920128/photo/1",195,974,47,1216
1452,1628381207720239112,2023-02-22 13:08:28,NemesisNemesi75,"Une enseignante d’espagnol de 52 ans poignardée à mort en plein cours par un élève de 16 ans. L’agresseur a été interpellé, il n’était pas connu des services de police . Il assurerait avoir été «possédé», selon des sources proches de l’enquête. https://www.liberation.fr/societe/police-justice/saint-jean-de-luz-une-professeur-de-lycee-poignardee-en-plein-cours-son-pronostic-vital-engage-20230222_IB2DNMZ4NBH5HNLXVWPAPQOZYY/?outputType=amp",24,76,6,106
1453,1628323733747249152,2023-02-22 09:20:05,NemesisNemesi75,Annemasse : un ‘‘coach en séduction’’ de 43 ans condamné pour agression sexuelle https://www.lemessager.fr/55549/article/2023-02-22/annemasse-il-urine-sur-sa-victime-un-coach-en-seduction-condamne-pour-agression,7,12,1,20
1454,1628319965546704898,2023-02-22 09:05:07,NemesisNemesi75,"Rattrapés par leur ADN, Mickaël Etcheverria et Jérémie Fontaine sont jugés jusqu’à vendredi pour un viol. En 2009, ils avaient violé et battu une femme de 43 ans à la sortie de la discothèque Arrena, à Bayonne. https://www.sudouest.fr/faits-divers/rattrapes-par-leur-adn-deux-hommes-juges-pour-un-viol-commis-a-bayonne-en-2009-14151875.php",34,80,6,120
1455,1627994498709037057,2023-02-21 11:31:49,NemesisNemesi75,https://nypost-com.translate.goog/2019/10/24/mom-finds-missing-teen-girl-by-spotting-her-on-pornhub/amp/?_x_tr_sl=en&_x_tr_tl=fr&_x_tr_hl=fr&_x_tr_pto=wapp,4,25,0,29
1456,1627994496897101826,2023-02-21 11:31:49,NemesisNemesi75,Cette œuvre d'art a été inspirée par son histoire : https://twitter.com/NemesisNemesi75/status/1627994496897101826/photo/1,12,77,1,90
1457,1627994490454646786,2023-02-21 11:31:47,NemesisNemesi75,Une perquisition de l’appartement de Johnson a révélé des informations provenant d'une clinique d’avortement. L'adolescente maltraitée a déclaré à la police qu'elle avait été enceinte de Johnson et qu'il l'avait emmenée dans une clinique pour se faire avorter.,14,64,1,79
1458,1627994488843956225,2023-02-21 11:31:47,NemesisNemesi75,"P*ornhub avait pourtant accordé le statut «vérifié» à cette victime dans son programme ""ModelHub"". Ce site a donc engendré des bénéfices de ses ventes de vidéos de viol. Twitter a récemment suspendu le compte ModelHub de P*rnhub.",19,72,1,92
1459,1627994486352609281,2023-02-21 11:31:46,NemesisNemesi75,"En 2019, une adolescente de 15 ans portée disparue depuis 1 an est retrouvée par les autorités de Floride chez un certain Christopher Johnson.

Elle a été violée dans plus d’une cinquantaine de vidéos postées sur des sites comme P*ornhub, Periscope ou encore SnapChat. https://twitter.com/NemesisNemesi75/status/1627994486352609281/photo/1",282,448,28,758
1460,1627969381178175488,2023-02-21 09:52:01,NemesisNemesi75,#OussamaAmmar https://twitter.com/NemesisNemesi75/status/1627969381178175488/video/1,10,41,0,51
1461,1627939076799094784,2023-02-21 07:51:36,NemesisNemesi75,Et dire que nous ne sommes que mardi… https://twitter.com/NemesisNemesi75/status/1627939076799094784/photo/1,93,197,8,298
1462,1627934556635512834,2023-02-21 07:33:38,NemesisNemesi75,Limoges : un clandestin algérien déjà sous OQTF pour des affaires de vols avec violence mis en examen pour le viol d’une femme retraitée de 66 ans. https://www.valeursactuelles.com/regions/nouvelle-aquitaine/haute-vienne/limoges/faits-divers/info-va-limoges-un-clandestin-algerien-sous-oqtf-et-deja-emprisonne-mis-en-examen-pour-viol,43,50,1,94
1463,1627932760290521090,2023-02-21 07:26:30,NemesisNemesi75,"Khalid Oussou a été condamné par le tribunal de Mulhouse à une peine de seulement 7 mois sous bracelet électronique pour un rapport sexuel non consenti avec une mineure de 13 ans, en mai 2020. https://www.lalsace.fr/amp/faits-divers-justice/2023/02/20/mulhouse-condamne-pour-un-rapport-sexuel-non-consenti-avec-une-enfant-de-13-ans",99,124,24,247
1464,1627930643249221633,2023-02-21 07:18:05,NemesisNemesi75,"La @PoliceNat33 lance un appel à témoins pour retrouver et féliciter un jeune homme qui a permis grâce à son intervention de stopper la tentative de viol d’une jeune fille le 3 février 2023 à Cenon. « PoliceNat33: Ce type d'appel à témoins se fait rare, je compte sur vous pour retrouver ce jeune courageux. https://twitter.com/PoliceNat33/status/1627694762126966786/photo/1 — https://twitter.com/policenat33/status/1627694762126966786 »",26,40,0,66
1465,1627928592272224256,2023-02-21 07:09:56,NemesisNemesi75,https://www.laprovence.com/actu/en-direct/1799135754366816/avignon-elle-mord-son-agresseur-a-la-langue?amp,1,20,0,21
1466,1627928590724595712,2023-02-21 07:09:56,NemesisNemesi75,un homme ensanglanté errant dans la rue avait été pris en charge par les pompiers et transporté à l’hôpital sous escorte des forces de l’ordre. Ce Tunisien sera jugé en comparution immédiate ce mercredi. Une obligation de quitter le territoire français lui a été délivrée.,20,108,6,134
1467,1627928589281755137,2023-02-21 07:09:55,NemesisNemesi75,Avignon : une femme agressée sexuellement par un Tunisien  en situation irrégulière mord son agresseur et lui sectionne un bout de langue en le mordant. Elle a pu remettre le bout de langue aux policiers qui ont fait le rapprochement avec une intervention de leurs collègues :,81,371,10,462
1468,1627625234323972096,2023-02-20 11:04:30,NemesisNemesi75,https://www.ouest-france.fr/societe/justice/le-proces-pour-viol-aggrave-du-chanteur-marocain-saad-lamjarred-s-est-ouvert-a-paris-c5e94c12-b101-11ed-9dce-00e6a0d5ca06,1,6,0,7
1469,1627625231962570754,2023-02-20 11:04:29,NemesisNemesi75,"La star marocaine Saad Lamjarred jugée pour un viol.
Le chanteur comparaît toute la semaine devant la cour d’assises de Paris. Il est accusé de viol et violence aggravés, des faits commis sur une jeune femme dans un palace en 2016. https://twitter.com/NemesisNemesi75/status/1627625231962570754/photo/1",44,95,10,149
1470,1627584184922275840,2023-02-20 08:21:23,NemesisNemesi75,"Villeurbanne : une femme aspergée d’ammoniaque au visage par un Algérien âgé de 25 ans. La victime âgée de 37 ans a été brûlée par le contenu irritant, notamment au niveau des yeux. Elle a été prise en charge par les secours puis hospitalisée. https://www.lyonmag.com/article/128582/villeurbanne-il-jette-de-l-ammoniac-au-visage-d-une-femme",92,124,9,225
1471,1626986176476241920,2023-02-18 16:45:07,NemesisNemesi75,"Le procès du radiologue Bassam El-Absi, poursuivi pour viols et agressions sexuelles débute lundi. Au moins sept ont porté plainte contre le docteur. Les premières plaintes ont été enregistrées à la gendarmerie en 2003. https://actu.fr/nouvelle-aquitaine/langon_33227/langon-le-proces-du-radiologue-bassam-el-absi-poursuivi-pour-viols-debute-lundi_57396032.html",7,18,1,26
1472,1626584245035765766,2023-02-17 14:07:59,NemesisNemesi75,Cette organisation a été financée à hauteur de 31 000 euros par la Commission européenne.,9,23,0,32
1473,1626584241705480196,2023-02-17 14:07:58,NemesisNemesi75,"Cette association islamiste tient des propos violents contre les femme, justifiait les attentats du Bataclan ou la décapitation de Samuel Paty et a été ussi été impliquée dans un scandale de mariage d’une fillette de 6 ans.",11,31,2,44
1474,1626584237381128194,2023-02-17 14:07:57,NemesisNemesi75,Extrait du discours de @J_Bardella à la Commission européenne sur le scandale Yavuz Sultan Selim. https://twitter.com/NemesisNemesi75/status/1626584237381128194/photo/1,25,89,2,116
1475,1626544908755517440,2023-02-17 11:31:40,NemesisNemesi75,https://www.lemonde.fr/societe/article/2023/02/17/l-etat-condamne-a-indemniser-sept-victimes-de-christian-n-qui-droguait-des-femmes-pour-les-forcer-a-uriner-devant-lui_6162208_3224.html,3,13,0,16
1476,1626544906507280389,2023-02-17 11:31:40,NemesisNemesi75,https://lespotiches.com/france/elysee/violences-sexistes-intoxication-abus-de-pouvoir-culture-ministere-inerte/,6,17,2,25
1477,1626544904083054593,2023-02-17 11:31:39,NemesisNemesi75,"L’Etat condamné à indemniser sept victimes de Christian Nègre, ancien membre du Haut Conseil à l’égalité entre les femmes et les hommes et ancien sous-directeur des ressources humaines au ministère de la culture, qui droguait des femmes pour les forcer à uriner devant lui. https://twitter.com/NemesisNemesi75/status/1626544904083054593/photo/1",135,218,18,371
1478,1626270462308229123,2023-02-16 17:21:07,NemesisNemesi75,"Toujours plus de femmes excisées en France, c’est donc ça le fameux enrichissement culturel ? 

Source : Le Parisien https://twitter.com/NemesisNemesi75/status/1626270462308229123/photo/1",204,477,11,692
1479,1626153590787014656,2023-02-16 09:36:43,NemesisNemesi75,"Alain Bonjour, un prêtre de 65 ans, est condamné à 6 ans de prison pour le viol d’une adolescente alors que celle-ci était venue se confier à lui après une tentative de suicide. https://www.leparisien.fr/amp/faits-divers/pas-de-calais-un-pretre-condamne-a-six-ans-de-prison-pour-le-viol-dune-adolescente-qui-venait-de-tenter-de-se-suicider-15-02-2023-IU33SFPX3JAV5OVWO6Y6OX7CC4.php",13,63,11,87
1480,1626152174345506819,2023-02-16 09:31:05,NemesisNemesi75,"Huit ans de prison pour un retraité polonais coupable de viol, en 2020. https://www.lavoixdunord.fr/1292151/article/2023-02-15/huit-ans-de-prison-pour-le-retraite-polonais-coupable-de-viol-en-2020-saint",11,20,1,32
1481,1626146368103362561,2023-02-16 09:08:01,NemesisNemesi75,https://www.leparisien.fr/amp/faits-divers/le-corps-demembre-aux-buttes-chaumont-est-bien-celui-dassia-46-ans-disparue-a-montreuil-15-02-2023-UKAZXKODLVBDHBP5YOCT4XLFNA.php,7,14,0,21
1482,1626146365729275906,2023-02-16 09:08:00,NemesisNemesi75,"Le corps retrouvé démembré aux Buttes-Chaumont est celui d’Assia Matoug, 46 ans, disparue à Montreuil. Le mari de cette mère de famille avait signalé sa disparition au commissariat le 6 février, une semaine avant la découverte macabre de son corps dans le parc parisien. https://twitter.com/NemesisNemesi75/status/1626146365729275906/photo/1",45,125,6,176
1483,1625839851177123840,2023-02-15 12:50:01,NemesisNemesi75,"Dominique P., qui droguait et faisait violer sa femme, aurait pu être neutralisé dès 2010 : la génétique le désignait dans un « cold case » dès 2010. Mais l’information, jamais exploitée, lui a permis d’échapper à la justice et de poursuivre ses méfaits. 
https://www.leparisien.fr/amp/faits-divers/dominique-p-le-mari-qui-droguait-et-faisait-violer-sa-femme-aurait-pu-etre-neutralise-des-2010-14-02-2023-X2E4MR4VWBDYDAQXELQNXQ7LBM.php",15,51,3,69
1484,1625838832082886659,2023-02-15 12:45:58,NemesisNemesi75,Paris : la femme retrouvée démembrée au parc des Buttes-Chaumont a été identifiée. Elle avait été déclarée disparue par son mari le 6 février. Le couple résidait en Seine-Saint-Denis. https://www.francetvinfo.fr/faits-divers/paris-le-corps-de-la-femme-retrouvee-decoupee-aux-buttes-chaumont-identifie_5660261.html,17,25,0,42
1485,1625765371968888833,2023-02-15 07:54:04,NemesisNemesi75,"Conduit au commissariat, il s'est rebellé et a sorti un couteau de son slip avec lequel il a tailladé l'oreille d'un policier. via @AmauryBucco",3,20,1,24
1486,1625765369527795713,2023-02-15 07:54:04,NemesisNemesi75,"Linto T., un SDF de 36 ans, est poursuivi pour exhibition sexuelle et violences sur personnes dépositaires de l'autorité publique. Il a été interpellé hier dans le RER, alors qu'il se masturbait devant les voyageurs. https://twitter.com/NemesisNemesi75/status/1625765369527795713/photo/1",21,82,5,108
1487,1625447486927130625,2023-02-14 10:50:54,NemesisNemesi75,Bonne fête à tous les amoureux ! #SaintValentin https://twitter.com/NemesisNemesi75/status/1625447486927130625/photo/1,23,173,2,198
1488,1625440739948650496,2023-02-14 10:24:06,NemesisNemesi75,"Il est susceptible de se rendre à Toulon, La Seyne-sur-Mer et Ollioules.

La direction départementale de la sécurité publique invite toutes personnes susceptibles d’avoir des informations permettant de localiser le fugitif à appeler le 17.

https://www.nicematin.com/faits-divers/ce-que-l-on-sait-sur-le-dangereux-fugitif-recherche-par-la-police-dans-l-aire-toulonnaise-827974",5,11,0,16
1489,1625440737746726913,2023-02-14 10:24:05,NemesisNemesi75,"Mohamed Meliani, un homme dangereux faisant l’objet d’un suivi psychiatrique s’est évadé d’un centre de détention près de Toulon. Il avait été condamné à quatre ans de prison ferme en septembre 2020 dans une affaire de séquestration et violences conjugales sur son ex-compagne. https://twitter.com/NemesisNemesi75/status/1625440737746726913/photo/1",49,108,13,170
1490,1625438275694473217,2023-02-14 10:14:18,NemesisNemesi75,"Nous apprenons par @leparisien_93 que le tueur s’appelle Petar, un ressortissant serbe, la victime s’appelle Neda, qui elle est d’origine Bulgare. https://www.leparisien.fr/amp/seine-saint-denis-93/sevran-une-femme-poignardee-a-mort-par-son-conjoint-dans-une-chambre-dhotel-13-02-2023-MNKYQ5ALXBBODMPPTVBUAXWBNE.php « NemesisNemesi75: Ce lundi 13 février 2023, une femme de 51 ans a été tuée de plusieurs coups de couteau par son mari à Sevran en Seine-Saint-Denis. 
https://actu.fr/ile-de-france/sevran_93071/seine-saint-denis-un-homme-poignarde-a-mort-sa-femme-dans-un-hotel_57351224.html — https://twitter.com/nemesisnemesi75/status/1625211690697560073 »",5,9,0,14
1491,1625435617457831936,2023-02-14 10:03:44,NemesisNemesi75,https://www.20min.ch/fr/story/deux-femmes-agressees-et-blessees-a-la-gare-de-zurich-277511110330,8,18,1,27
1492,1625435615687847936,2023-02-14 10:03:44,NemesisNemesi75,"Suisse: 2 femmes agressées par un Érythréen. La première était inconsciente, couchée dans une mare de sang, l’homme continuait de la frapper à coups de pied. Une femme de 16 ans a tenté de porter secours à la victime et a reçu des coups. Les 2 femmes ont dû être hospitalisées",50,150,5,205
1493,1625433507228012544,2023-02-14 09:55:21,NemesisNemesi75,"« Mon mari va me tuer » : à Bondy, une enquête ouverte pour « homicide par conjoint » après le décès à l’hôpital d’une femme de 34 ans après avoir été retrouvée inanimée chez elle par les forces de l’ordre, en Seine-Saint-Denis. https://www.leparisien.fr/amp/seine-saint-denis-93/bondy-93140/mon-mari-va-me-tuer-a-bondy-une-enquete-ouverte-pour-homicide-par-conjoint-apres-le-deces-dune-femme-12-02-2023-YOVOOOT3YBBTBAO6J5HTFXKOKI.php",18,34,2,54
1494,1625211690697560073,2023-02-13 19:13:56,NemesisNemesi75,"Ce lundi 13 février 2023, une femme de 51 ans a été tuée de plusieurs coups de couteau par son mari à Sevran en Seine-Saint-Denis. 
https://actu.fr/ile-de-france/sevran_93071/seine-saint-denis-un-homme-poignarde-a-mort-sa-femme-dans-un-hotel_57351224.html",6,13,0,19
1495,1625170102906720257,2023-02-13 16:28:41,NemesisNemesi75,"⚠️Paris : un corps de femme découpé retrouvé aux Buttes-Chaumont⚠️
 https://france3-regions.francetvinfo.fr/paris-ile-de-france/paris/paris-un-corps-de-femme-decoupe-retrouve-aux-buttes-chaumont-2713442.html",14,25,3,42
1496,1624343773143527424,2023-02-11 09:45:09,NemesisNemesi75,"Il reconnait aussi avoir jeté une cigarette en direction de la victime mais nie l’intention de tuer. 
https://actu.fr/normandie/yvetot_76758/une-femme-brulee-vive-a-yvetot-son-conjoint-nie-avoir-voulu-la-tuer_57277283.html",7,22,2,31
1497,1624343771503624192,2023-02-11 09:45:08,NemesisNemesi75,"Une femme brûlée vive à Yvetot, son conjoint mis en examen pour homicide volontaire. Il admet son état d’ébriété avancé ce soir-là, et avoir mis le feu à un gilet appartenant à la victime (qu’elle ne portait pas) pendant qu’elle dormait",22,80,1,103
1498,1624342259435962369,2023-02-11 09:39:08,NemesisNemesi75,"Yvelines : cinq adolescents mis en examen pour ""agressions sexuelles"" et ""viols"" sur une mineure de 15 ans. https://www.francetvinfo.fr/societe/harcelement-sexuel/yvelines-cinq-adolescents-mis-en-examen-pour-agressions-sexuelles-et-viols-sur-une-mineure-de-15-ans_5651792.html",22,36,5,63
1499,1624341616419905537,2023-02-11 09:36:34,NemesisNemesi75,"Yannick N., alias Mr WaynZ, streamer qui a connu une certaine notoriété sur Twitch et YouTube, jugé à Paris pour une tentative de meurtre, des viols et des séquestrations sur des ex-compagnes. Il est condamné à 18 ans de réclusion. https://www.leparisien.fr/amp/faits-divers/le-streamer-mr-waynz-condamne-a-18-ans-de-reclusion-pour-des-viols-des-violences-et-des-sequestrations-10-02-2023-7BQUWGKOZNEVJD2WNXN5JTQ5XU.php https://twitter.com/NemesisNemesi75/status/1624341616419905537/photo/1",18,74,7,99
1500,1624340878859829250,2023-02-11 09:33:38,NemesisNemesi75,"En Seine-Saint-Denis, 7,2 % des 18-45 ans ont été victimes d’excision. 39% des femmes victimes d’entre elles sont nées à l’étranger. À l’inverse, une majorité des victimes seraient donc nées en France. 

https://www.leparisien.fr/amp/seine-saint-denis-93/je-sens-toujours-la-lame-en-moi-en-seine-saint-denis-72-des-18-49-ans-ont-ete-victimes-dexcision-06-02-2023-FMIDNGBIIBD65PKF3G6AG5QBAE.php",59,93,6,158
1501,1623738607348350988,2023-02-09 17:40:26,NemesisNemesi75,"Selon son entourage, il avait notamment l'habitude de prendre des photos ou des vidéos de ses conquêtes nues et pendant leur sommeil, soit sans leur consentement. https://www.bfmtv.com/amp/police-justice/disparition-d-helena-cluyou-a-brest-ce-que-l-on-sait-sur-sylvain-l-principal-suspect_AN-202302090400.html",8,40,2,50
1502,1623738605351981058,2023-02-09 17:40:25,NemesisNemesi75,"En plus de ses problèmes de drogues, Sylvain L. a également un comportement parfois problématique avec les femmes. S'il se qualifie lui-même de ""tombeur"", ses agissements allaient plus loin qu'une simple drague lourde.",8,38,1,47
1503,1623738603175043074,2023-02-09 17:40:25,NemesisNemesi75,"Ce Brestois était connu des forces de l’ordre pour des faits mineurs de vols mais sans casier judiciaire, 
https://www.sudouest.fr/faits-divers/disparition-d-helena-a-brest-qui-est-sylvain-l-principal-suspect-seducteur-et-sans-limites-13968790.php",8,32,3,43
1504,1623738601442869253,2023-02-09 17:40:24,NemesisNemesi75,"Bien que décrit comme « non violent » par l’une de ses anciennes petites amies, des soupçons de violence conjugale pèsent sur lui, ses voisins ayant déjà signalé à la police avoir entendu les hurlements de sa nouvelle compagne.",10,41,1,52
1505,1623738599739912192,2023-02-09 17:40:24,NemesisNemesi75,D’après des proches il avait l’habitude de « rentrer en voiture souvent en état d’ivresse » et était réputé pour sa consommation excessive d’alcool et de stupéfiants (cocaïne).,10,52,1,63
1506,1623738597302992897,2023-02-09 17:40:23,NemesisNemesi75,"Sylvain L., principal suspect dans l’affaire de la disparition d’Helena Cluyou est décédé à l’hôpital. Il s’était installé à Brest après avoir suivi une formation de cuisinier dans la Légion étrangère. https://twitter.com/NemesisNemesi75/status/1623738597302992897/photo/1",124,237,25,386
1507,1623396484304470022,2023-02-08 19:00:57,NemesisNemesi75,https://www.surfsession.com/articles/vous-pensez-quoi/la-wsl-annonce-nouvelle-politique-athletes-transgenres-206233842.html,1,8,0,9
1508,1623396482320592899,2023-02-08 19:00:57,NemesisNemesi75,"Bethany Hamilton, une surfeuse américaine qui a survécu à une attaque de requin et continue de surfer malgré la perte de son bras gauche, a fait savoir qu'elle ne participerait plus à des compétitions s'ils autorisaient les hommes biologiques à surfer dans les épreuves féminines. https://twitter.com/NemesisNemesi75/status/1623396482320592899/photo/1",142,994,27,1163
1509,1622905489708265472,2023-02-07 10:29:55,NemesisNemesi75,L’excuse de minorité pour l’accusé qui avait 17 ans au moment des faits doit absolument être levé. https://france3-regions.francetvinfo.fr/provence-alpes-cote-d-azur/bouches-du-rhone/marseille/meurtre-de-marie-belen-pisano-cinq-choses-a-savoir-sur-le-proces-a-la-cour-d-assises-des-mineurs-des-bouches-du-rhone-2708750.html,9,28,0,37
1510,1622905487627849730,2023-02-07 10:29:55,NemesisNemesi75,"Le verdict est attendu le 10 février. Le dernier jour d'audience, la famille de Marie-Bélen Pisano appelle à un rassemblement, à 17 heures devant la cour d'Assises à Aix-en-Provence et à 18h30 à place de la République, à Paris.",9,29,1,39
1511,1622905486004695042,2023-02-07 10:29:54,NemesisNemesi75,"""C'est important que les gens sachent qu'elle ne l'a pas cherché, j'attends de ce procès que les gens prennent conscience que c'est arrivé à ma fille mais que ça arrive à beaucoup de filles"", a déclaré très émue la mère de Marie-Bélen.",7,31,1,39
1512,1622905484456910849,2023-02-07 10:29:54,NemesisNemesi75,"Pour la famille de la victime, le vol n'est pas le mobile de ce meurtre et défend la thèse d'un ""féminicide non intime"" : selon elle, ""des images montrent clairement que le téléphone portable n’était pas ce qui intéressait l’assassin"".",6,27,1,34
1513,1622905482280042496,2023-02-07 10:29:53,NemesisNemesi75,"🛑 Le procès de Fayçal pour le meurtre de Marie-Bélen Pisano s’est ouvert ce lundi 6 février devant la cour d’assises des mineurs à Aix-en-Provence. Le 17 mars 2019, il avait poignardé au cœur l’étudiante de 21 ans à la sortie du métro Timone à Marseille. https://twitter.com/NemesisNemesi75/status/1622905482280042496/photo/1",106,149,10,265
1514,1622902573802967040,2023-02-07 10:18:20,NemesisNemesi75,"Gironde : condamné à 11 reprises, un individu de 49 ansné en Algérie a tenté de violer une adolescente en pleine rue. C’est grâce à l’intervention d’un garçon de son âge, que la victime a pu prendre la fuite. https://www.valeursactuelles.com/regions/nouvelle-aquitaine/gironde/no_agglomeration/faits-divers/gironde-condamne-a-11-reprises-un-individu-ne-en-algerie-a-tente-de-violer-une-adolescente-en-pleine-rue",26,52,1,79
1515,1622886499988406273,2023-02-07 09:14:28,NemesisNemesi75,Gironde : un couple découvert mort. L’homme tenait dans sa main un pistolet et a laissé un mot à leur ado pour s’excuser de son geste et lui demandant de ne pas rentrer dans la chambre. L’homme avait expliqué ne pas supporter la séparation. https://www.ouest-france.fr/nouvelle-aquitaine/gironde/gironde-un-couple-decouvert-mort-la-piste-du-feminicide-suivi-de-suicide-privilegiee-20991bcc-a655-11ed-acf1-1f171930b7f8,4,11,2,17
1516,1622646388801536207,2023-02-06 17:20:21,NemesisNemesi75,"Pourtant, d’après un rapport de Santé publique France, le nombre de femmes ayant subi une forme de mutilations génitales est en constante expansion et a même doublé en l’espace de quelques années à cause de l’immigration. 

http://beh.santepubliquefrance.fr/beh/2019/21/pdf/2019_21_1.pdf",13,37,4,54
1517,1622646384879861773,2023-02-06 17:20:20,NemesisNemesi75,Le 6 février est la «Journée internationale de la tolérance zéro à l’égard des mutilations génitales féminines». https://twitter.com/NemesisNemesi75/status/1622646384879861773/video/1,60,152,9,221
1518,1622596502185996288,2023-02-06 14:02:07,NemesisNemesi75,"Preet Chandi, une femme officier dans l’armée britannique vient de battre non seulement le record du monde de la plus longue expédition polaire en solo et sans assistance par une femme, mais aussi le record global. https://www.bbc.com/news/uk-england-derbyshire-64455412.amp",7,49,3,59
1519,1622586148693442562,2023-02-06 13:20:58,NemesisNemesi75,https://www.francetvinfo.fr/faits-divers/disparition-d-helena-cluyou-un-suspect-identifie-par-les-enqueteurs_5643449.html,1,8,1,10
1520,1622586146852151298,2023-02-06 13:20:58,NemesisNemesi75,"Disparition d’Helena Cluyou : un suspect identifié par les enquêteurs, un Brestois de 36 ans sans casier judiciaire. Il pourrait avoir percuté la jeune fille avec sa voiture samedi 28 janvier. Pris de panique, le suspect aurait ensuite dissimulé le corps. Il a tenté de suicider .",20,75,5,100
1521,1622541147292712961,2023-02-06 10:22:09,NemesisNemesi75,« Aucune audition » de cet homme né en 1996 n’a été possible. Le nourrisson est toujours dans un état critique. https://www.sudouest.fr/faits-divers/une-mere-et-son-bebe-de-2-mois-poignardes-dans-le-jura-la-garde-a-vue-du-suspect-a-ete-levee-13949209.php,9,26,3,38
1522,1622541145153617932,2023-02-06 10:22:09,NemesisNemesi75,"Jura : un nourrisson de 2 mois éventré et sa mère poignardée. Dans un premier temps, l’état de santé de l’homme interpellé avait été jugé « compatible avec une garde à vue. Mais le psychiatre qui l’a examiné ensuite l’a jugé au contraire « incompatible » avec la garde à vue.",63,154,11,228
1523,1622239211926568963,2023-02-05 14:22:22,NemesisNemesi75,"Dankjewel to @vbjongeren , the youth organisation of @vlbelang 
for their invitation ! https://twitter.com/NemesisNemesi75/status/1622239211926568963/photo/1",18,119,3,140
1524,1621894138453975043,2023-02-04 15:31:10,NemesisNemesi75,@berlioz56autone @StellaKamnga t’inquiètes pas pour son courage dans la réalité va,0,2,0,2
1525,1621631689003769861,2023-02-03 22:08:17,NemesisNemesi75,"L’une de nos abonnées vient de nous envoyer cette vidéo d’agression verbale dont elle a été victime par cet homme.
Ce dernier demandait en effet à son fils de désigner la « meuf la plus bonne du wagon » ou comment éduquer à devenir un harceleur sexuel dès le plus jeune âge.",341,848,55,1244
1526,1621503144889835520,2023-02-03 13:37:30,NemesisNemesi75,Près de Lyon : un réfugié afghan condamné à seulement 30 mois ferme pour l’agression sexuelle d’une petite fille de 4 ans https://www.lyonmag.com/article/128294/pres-de-lyon-un-refugie-afghan-condamne-pour-l-agression-sexuelle-d-une-petite-fille-de-4-ans,104,191,19,314
1527,1621214096740827143,2023-02-02 18:28:56,NemesisNemesi75,https://www.rci.fm/martinique/infos/Faits-divers/Feminicide-presume-la-femme-blessee-au-Gros-Morne-est-decedee,1,4,0,5
1528,1621214094580744192,2023-02-02 18:28:55,NemesisNemesi75,"Martinique : hier soir, une femme de 37 ans aurait été mortellement agressée par son ex-conjoint. En décembre dernier, elle avait déposé une plainte pour harcèlement à la gendarmerie. Son ex-conjoint devait comparaître ce mois-ci. Il a été interpellé ce matin par la gendarmerie.",15,35,4,54
1529,1621108176732184579,2023-02-02 11:28:02,NemesisNemesi75,"Mahfoud Hansali avait 13 condamnations à son actif, et devait passer hier devant la justice pour une affaire de séquestration, il était pourtant dehors. Encore une fois, une jeune femme fait les frais de notre justice si laxiste qu’elle en devient complice. #justicepoursihem https://twitter.com/NemesisNemesi75/status/1621108176732184579/photo/1",444,1152,28,1624
1530,1621106605436846080,2023-02-02 11:21:48,NemesisNemesi75,"Depuis lundi, tous les effectifs finistériens de la police judiciaire se mobilisent pour retrouver Eléna Cluyou. https://twitter.com/NemesisNemesi75/status/1621106605436846080/photo/1",59,84,6,149
1531,1621054312024506368,2023-02-02 07:54:00,NemesisNemesi75,https://www.leparisien.fr/amp/faits-divers/la-jeune-sihem-retrouvee-morte-dans-une-foret-02-02-2023-OMLU73UDWZH4DLIDV3A4XPKZDQ.php,14,38,2,54
1532,1621054310552408064,2023-02-02 07:54:00,NemesisNemesi75,"Nous apprenons à l’instant que le corps de la jeune #Sihem vient d’être retrouvé dans une forêt. Mahfoud H., le principal suspect, est passé aux aveux cette nuit. Nous adressons nos condoléances à sa famille et nous leur souhaitons beaucoup de courage dans cette terrible épreuve.",177,685,22,884
1533,1621052673310195713,2023-02-02 07:47:29,NemesisNemesi75,"Délinquance : d’après les chiffres publiés par le ministère de l’Intérieur mardi dernier, la quasi-totalité des crimes et délits en hausse en 2022. Avec 11% d’augmentation, les violences sexuelles font partie des augmentations les plus importantes. https://www.leparisien.fr/faits-divers/delinquance-la-quasi-totalite-des-crimes-et-delits-en-hausse-en-2022-31-01-2023-WZ57YJUEGREUJEMAPVB35FGLPQ.php",22,33,1,56
1534,1621048841285021696,2023-02-02 07:32:16,NemesisNemesi75,https://www.sudouest.fr/societe/royaume-uni-pres-la-moitie-des-jeunes-pensent-que-la-plupart-des-filles-apprecient-les-actes-d-agression-sexuelle-13885275.amp.html,2,8,0,10
1535,1621048839573766144,2023-02-02 07:32:15,NemesisNemesi75,"Rachel de Souza, commissaire à l’enfance raconte : « Je n’oublierai jamais la fille qui m’a raconté son premier baiser avec son petit ami, âgé de 12 ans, qui l’a étranglée. Il l’avait vu dans des films pornographiques et trouvait cela normal. »",5,25,1,31
1536,1621048837828911104,2023-02-02 07:32:15,NemesisNemesi75,"Selon le rapport, « les utilisateurs fréquents de pornographie sont plus susceptibles de se livrer à des actes sexuels physiquement agressifs ».",7,32,1,40
1537,1621048836218028032,2023-02-02 07:32:14,NemesisNemesi75,"Selon un rapport publié mardi sur l’impact de la pornographie sur les jeunes au Royaume-Uni, 42 % des jeunes pensent que la plupart des filles « apprécient » les actes d’agression sexuelle.",26,96,8,130
1538,1621046549039165448,2023-02-02 07:23:09,NemesisNemesi75,https://m.20minutes.fr/amp/a/4021483,3,16,1,20
1539,1621046546958786562,2023-02-02 07:23:09,NemesisNemesi75,"Montpellier : un homme jugé pour avoir violé pendant des années la fille adoptive de sa compagne, orpheline depuis le meurtre de sa mère, tuée en 2010 par son père. La compagne de l’accusé, tante et mère adoptive de la plaignante, est aussi jugée pour non-dénonciation des faits.",64,152,9,225
1540,1621043889007386625,2023-02-02 07:12:35,NemesisNemesi75,"Donc pour récapituler, nous avons encore une fois affaire à un multirécidiviste qui écope d’une peine de 12 ans en 2015 et qui est déjà dehors 8 ans plus tard. Et il est probable qu’encore une fois, nous ayons attendu qu’il s’en prenne à une jeune femme pour agir.",18,58,4,80
1541,1621043886964543489,2023-02-02 07:12:34,NemesisNemesi75,"🛑 Disparition de Sihem Belouahmia : un certain Mahfoud H. a été placé en GAV ainsi que son ex-femme. Condamné en 2015 à 12 ans de prison pour plusieurs vols et braquages à main armée, il devait comparaître ce mercredi pour une affaire de séquestration remontant à 2011. https://twitter.com/NemesisNemesi75/status/1621043886964543489/photo/1",53,113,8,174
1542,1620774809872502785,2023-02-01 13:23:21,NemesisNemesi75,"Le gouvernement présente aujourd’hui son projet de loi immigration. 
https://www.lepoint.fr/politique/que-contient-le-projet-de-loi-immigration-01-02-2023-2507003_20.php",4,9,2,15
1543,1620718079184621570,2023-02-01 09:37:56,NemesisNemesi75,Merci à @Nicolas_Sunrise pour son invitation dans son émission. Notre militante Athenia a pu parler de notre action de ce week-end #NoHijabDay .                                              ➡️À voir ici : https://m.youtube.com/watch?v=JJMLMCBKoRg&t=2897s et n’oubliez pas de vous abonner à sa chaîne !,10,27,0,37
1544,1620701725446504448,2023-02-01 08:32:57,NemesisNemesi75,https://www.sudouest.fr/justice/landes-un-dacquois-mis-en-examen-pour-viol-et-actes-de-barbarie-13889392.php,0,10,0,10
1545,1620701723357765634,2023-02-01 08:32:56,NemesisNemesi75,"Landes : un homme mis en examen pour viol et actes de barbarie. Fin janvier, il s’en serait pris à sa petite amie, laissée totalement défigurée. Il était déjà connu de la justice pour un épisode violent et pour des infractions liées à la législation sur les stupéfiants.",21,76,1,98
1546,1620696357244895232,2023-02-01 08:11:37,NemesisNemesi75,https://www.parisvox.info/2023/01/31/hijab-day-des-revendications-et-une-question/,13,40,2,55
1547,1620504090102075392,2023-01-31 19:27:37,NemesisNemesi75,"Ça va la @UEFrance on ne vous dérange pas trop ? « DamienRieu: Pour la confrérie islamiste @ismailaga_cami, les femmes ne doivent ni étudier, ni travailler, ni sortir dans la rue et se satisfaire d'être ""une épouse obéissante à son maître et donner naissance à des soldats pour la nation et le peuple""... 

11/23 https://twitter.com/DamienRieu/status/1620482411036557314/photo/1 — https://twitter.com/damienrieu/status/1620482411036557314 »",19,58,2,79
1548,1620315998292439040,2023-01-31 07:00:12,NemesisNemesi75,"Dans les prisons mauriciennes, 72% des détenus condamnés pour violences sexuelles sont des récidivistes. Partant de ce constat, une nouvelle loi pourrait imposer une castration chimique. https://la1ere.francetvinfo.fr/mayotte/maurice-vers-la-castration-chimique-des-auteurs-d-agressions-sexuelles-1361122.html",18,51,2,71
1549,1620313510025789440,2023-01-31 06:50:19,NemesisNemesi75,"Le streamer « Mr WaynZ » est renvoyé devant la cour d’assises de Paris, à partir de ce mardi, pour les viols, tentatives de meurtres et séquestration de quatre jeunes femmes. https://www.20minutes.fr/justice/4020691-20230130-viol-tentative-meurtre-sequestration-streameur-mr-waynz-devant-assises https://twitter.com/NemesisNemesi75/status/1620313510025789440/photo/1",38,117,5,160
1550,1620312724554256385,2023-01-31 06:47:12,NemesisNemesi75,@BillCarbaunate Merci ! L’affiche est de notre militante graphiste qui tient à garder l’anonymat ;),0,1,0,1
1551,1620122253383057409,2023-01-30 18:10:20,NemesisNemesi75,@havadarmoutioun Merci beaucoup !,0,1,0,1
1552,1620104809536950272,2023-01-30 17:01:01,NemesisNemesi75,"Alors si vous trouvez nos actions utiles, si vous pensez que nous devons les multiplier, vous pouvez nous aider financièrement par le biais de notre lien paypal : 

https://www.paypal.com/donate/?cmd=_s-xclick&hosted_button_id=3YKTNP3ARC5CJ&source=url&fbclid=PAAaYRVn2b7XJ-qFLZMBJmBI1wwuXXL4azpwHL67LmZPc2x6AGPn6UTxB0gRA

Merci infiniment et soyez sûrs que nous ne lâcherons rien.",2,10,1,13
1553,1620104807574020097,2023-01-30 17:01:00,NemesisNemesi75,"Entre l’achat du matériel, les costumes, l’aide aux frais de déplacements (nos militantes sont majoritairement étudiantes), les frais du No Hijab Day s’élève à plusieurs milliers d’euros, ce qui est une somme énorme pour nous.",4,22,3,29
1554,1620104803329413120,2023-01-30 17:00:59,NemesisNemesi75,"Parce que nous le faisons pour nos filles, mais aussi pour les votres, nous vous proposons de participer à la réalisation de nos actions en nous aidant à les financer via ce lien : https://tinyurl.com/2p8mj2th https://twitter.com/NemesisNemesi75/status/1620104803329413120/photo/1",56,173,4,233
1555,1619983267427663873,2023-01-30 08:58:03,NemesisNemesi75,"Il vient d’être condamné à deux ans de prison, dont un ferme, par le tribunal correctionnel de Beauvais pour avoir abusé sexuellement d’une mineure.",13,50,8,71
1556,1619983265414397952,2023-01-30 08:58:02,NemesisNemesi75,"Daniel Genty, adjoint au maire, était jugé le 26 janvier, 18 ans après les faits. Il abusait sexuellement de Sophie*, 12 ans à l’époque. À 15 ans, Sophie tombe enceinte. Le quadragénaire la conduit lui-même dans une maternité pour qu’elle se fasse avorter. https://www.courrier-picard.fr/id382482/article/2023-01-26/beaudeduit-ladjoint-au-maire-couchait-avec-une-collegienne-de-12-ans",89,122,8,219
1557,1619977904464728065,2023-01-30 08:36:44,NemesisNemesi75,https://amp.lefigaro.fr/faits-divers/limoges-une-femme-tuee-d-une-balle-dans-la-tete-par-son-compagnon-20230129,3,8,0,11
1558,1619977902749274112,2023-01-30 08:36:44,NemesisNemesi75,"À Limoges Farid F., a été placé en garde à vue. Il est suspecté d’avoir tué d’une balle dans la tête sa compagne. Selon ses dires, un coup serait parti accidentellement avant d'atteindre la tête de sa compagne, alors assise sur le canapé. Le pistolet était détenu illégalement",42,94,10,146
1559,1619709631789670400,2023-01-29 14:50:43,NemesisNemesi75,@AntoineGoya @MagLincorrect @collnemesis Donc Ben Laden chez qui on a retrouvé des films n’était pas musulman intégriste ?,0,1,0,1
1560,1619673929181954049,2023-01-29 12:28:51,NemesisNemesi75,@AntoineGoya @MagLincorrect @collnemesis Le fait qu’ils picolent et qu’ils écoutent du rap n’empêchera pas la montée de l’islamisme.,0,8,0,8
1561,1619673678190620674,2023-01-29 12:27:51,NemesisNemesi75,"@AntoineGoya @MagLincorrect @collnemesis Oui, nous assumons notre choix de civilisation, il est tout à fait naïf de penser que 2 civilisation peuvent cohabiter. Et citer les pays des Balkans comme modèle il faut vraiment oser, ces pays ont été ravagés par les guerre de religions justement.",0,2,0,2
1562,1619671361298866178,2023-01-29 12:18:39,NemesisNemesi75,"@AntoineGoya @MagLincorrect @collnemesis Oui bien sur, l’islam se casse tellement les dents en Occident que le nombre de mosquées ne cesse d’augmenter, qu’il n’y a jamais autant de femmes voilées et que les 3/4 des jeunes musulmans en France ne croient pas en l’évolution…",0,14,1,15
1563,1619670593888227329,2023-01-29 12:15:36,NemesisNemesi75,@AntoineGoya @MagLincorrect @collnemesis Leur existence même implique une volonté hégémonique et nous avons toujours été claires à ce sujet : le voile islamique n’a pas sa place en Europe. Paradoxe de la tolérance tout ça…,0,3,0,3
1564,1619668395863207936,2023-01-29 12:06:52,NemesisNemesi75,"@AntoineGoya @MagLincorrect @collnemesis Quand la situation de gauche se est majoritaire, elle ne permet plus à celle de droite d’exister",0,1,0,1
1565,1619668104325517314,2023-01-29 12:05:42,NemesisNemesi75,"@AntoineGoya @MagLincorrect @collnemesis Non, vu la démographie il n’y aura pas de choix possible.",0,3,1,4
1566,1619666962631782402,2023-01-29 12:01:10,NemesisNemesi75,@AntoineGoya @MagLincorrect @collnemesis Tu nous as habitué à plus d’argumentation que ça @AntoineGoya,0,4,0,4
1567,1619640510725120001,2023-01-29 10:16:03,NemesisNemesi75,"«Nous ne nous rendons pas compte de la chance que nous avons de vivre dans la civilisation européenne, jusqu’au moment ou nous la perdrons. 

N’attendons donc plus pour la défendre. » #NoHijabDay https://twitter.com/NemesisNemesi75/status/1619640510725120001/video/1",340,828,46,1214
1568,1619622807712956416,2023-01-29 09:05:43,NemesisNemesi75,Nous étions donc une cinquantaine de militantes réunies au pied du Sacré-Coeur pour dire non à l’islamisation et oui à la civilisation européenne. https://twitter.com/NemesisNemesi75/status/1619622807712956416/photo/1,70,231,11,312
1569,1619622785600606208,2023-01-29 09:05:37,NemesisNemesi75,"Le #WorldHijabDay sera célébré le 1er février dans plus d’une centaine de pays, dont la France.

Il arrive chez nous par le biais de grandes écoles, censées former les élites qui nous dirigeront demain, comme @sciencespo , https://twitter.com/NemesisNemesi75/status/1619622785600606208/photo/1",88,205,8,301
1570,1619622777497223168,2023-01-29 09:05:35,NemesisNemesi75,"#NOHIJABDAY

parce que c’est un choix entre :

- l’obscurantisme ou la liberté 
- une civilisation qui cache les femmes ou une civilisation qui éduque les hommes
- l’islamisme ou l’Occident

Quelle civilisation voulez-vous ? https://twitter.com/NemesisNemesi75/status/1619622777497223168/photo/1",305,753,36,1094
1571,1619607960719589376,2023-01-29 08:06:43,NemesisNemesi75,@MagLincorrect @collnemesis Merci ! par contre notre twitter c’est celui-ci ;) @NemesisNemesi75,5,71,2,78
1572,1619316557188042754,2023-01-28 12:48:47,NemesisNemesi75,Essonne : Enquête ouverte après le viol présumé d'une adolescente de 15 ans souffrant d’un important retard mental par un réfugié afghan mineur dans un foyer d'Étampes https://actu17.fr/amp/faits-divers/essonne-enquete-ouverte-apres-le-viol-presume-dune-adolescente-par-un-refugie-afghan-mineur.html,35,62,4,101
1573,1619273525575155712,2023-01-28 09:57:47,NemesisNemesi75,"@FrHuToTea Il n’y a pas besoin d’être expert, les articles à ce sujet et les programmateurs eux-mêmes le disent. C’est comme Midjourney qui est bridé pour éviter les contenus pornographique. https://www.numerama.com/tech/1243132-derriere-chatgpt-le-traumatisme-de-travailleurs-sous-payes-pour-moderer-lia.html",0,2,0,2
1574,1619272622080131073,2023-01-28 09:54:12,NemesisNemesi75,"@FrHuToTea S´il n’apprend vraiment que par internet, pourquoi toutes les opinions ne sont pas toutes représentées dans ce cas ? Évidemment qu’il y a une intervention humaine pour éviter des opinions politiquement incorrectes. Rappelez-vous l’IA « Tay» de Microsoft qui avait « dérapé ».",0,2,1,3
1575,1619270916952956930,2023-01-28 09:47:25,NemesisNemesi75,@FrHuToTea Nous utilisons #ChatGPT pour la blague mais en soi ce n’est pas très important. Les étudiants en socio et autres militants te servent exactement la même soupe qui sert de base aux réponses de ceux qui ont programmé #ChatGPT,1,7,1,9
1576,1619269886978703360,2023-01-28 09:43:20,NemesisNemesi75,"Évidemment, allons jusqu’au bout. Donc la race n’existe pas mais elle est quand même génétiquement déterminée. Elle n’existe pas mais on ne peut pas en changer. Mais Il est possible de changer de genre en adoptant les clichés attribués à l’autre genre. https://twitter.com/NemesisNemesi75/status/1619269886978703360/photo/1",14,36,1,51
1577,1619266511818067971,2023-01-28 09:29:55,NemesisNemesi75,"Donc pour récapituler : le genre et la race/ethnie sont socialement construits. Mais dans le premier cas tu peux en changer et dans l’autre non 🙃. Dans un cas tu peux t’approprier des caractéristiques physiques, un vécu, une histoire, et dans l’autre non. #ChatGPT https://twitter.com/NemesisNemesi75/status/1619266511818067971/photo/1",31,104,5,140
1578,1619031961049391104,2023-01-27 17:57:54,NemesisNemesi75,"Mercredi, un migrant algérien en situation irrégulière a été arrêté pour le viol d’une jeune femme de 19 dans un TER qui reliait Lyon à Grenoble.
https://www.leprogres.fr/faits-divers-justice/2023/01/27/une-femme-violee-dans-un-ter-lyon-grenoble",45,72,4,121
1579,1618972640181645312,2023-01-27 14:02:11,NemesisNemesi75,"Donovan R., 20 ans, mis en examen pour homicide volontaire aggravé et placé, en détention provisoire. Il est accusé d’avoir tué d'un coup de fusil de chasse en pleine tête sa compagne Eva Hospital, une jeune étudiante de 20 ans elle aussi. https://www.lamontagne.fr/clermont-ferrand-63000/actualites/l-auteur-presume-de-l-homicide-conjugal-de-lempdes-evoque-un-tir-accidentel_14252764/",6,14,0,20
1580,1618959836414365697,2023-01-27 13:11:18,NemesisNemesi75,Le fils du ministre de la Justice @E_DupondM en garde à vue m. Il est soupçonné de violences conjugales https://fr.news.yahoo.com/eric-dupond-moretti-dévasté-tant-122824366.html,37,50,7,94
1581,1618894186195091458,2023-01-27 08:50:26,NemesisNemesi75,"Finalement Isla Bryson, un transgenre condamné pour des faits de viol sur deux femmes lorsqu’il était Adam Graham, n’ira pas dans la prison pour femmes de Cornton Vale. La polémique ayant suscité un tollé au Royaume-Uni . https://amp.lepoint.fr/2506382 https://twitter.com/NemesisNemesi75/status/1618894186195091458/photo/1",24,65,9,98
1582,1618892257817677826,2023-01-27 08:42:46,NemesisNemesi75,"Rokia* continue de craindre son mari : bien qu’il soit incarcéré pour viol, celui-ci continue de la harceler en l’appelant depuis le prison. « Tout ce que m’a dit le juge, c’est de changer de numéro » explique la victime. https://www.leparisien.fr/amp/essonne-91/accuse-de-viol-en-recidive-par-sa-femme-il-a-horreur-quon-lui-dise-non-sexuellement-26-01-2023-K2FZQNLTLNBWZPWIHJP3ST5ODQ.php",23,36,0,59
1583,1618666879144562688,2023-01-26 17:47:12,NemesisNemesi75,Baromètre du sexisme 2023 : le résumé en 2 minutes sur les points les plus importants. https://youtu.be/vqWwvP6ew1c,4,9,0,13
1584,1618633822035378179,2023-01-26 15:35:50,NemesisNemesi75,"🛑 « Il prend quatorze ans de prison et au bout de quelques mois, on le relâche. » Jean-Claude Gorzela, leur ancien patron, a été condamné pour viol. Il vient d’être remis en liberté. Ces 4 femmes crient à l'injustice. https://actu.fr/normandie/beuzeville_27065/leur-ancien-patron-accuse-de-viol-remis-en-liberte-ces-femmes-crient-a-linjustice_56826503.html",45,82,2,129
1585,1618628813411463168,2023-01-26 15:15:56,NemesisNemesi75,"Un ex- ingénieur d’ArcelorMittal condamné pour voyeurisme aggravé. Plus de 100 000 photos de ses collègues espionnées aux toilettes avaient été retrouvées sur son ordinateur. 

https://tinyurl.com/3sz7kx5s",9,16,1,26
1586,1618535421469949955,2023-01-26 09:04:50,NemesisNemesi75,"A Paris, Catherine D., meurt empoisonnée au mercure. Son ex-compagnon en garde à vue après que la police a trouvé des flacons contenant du produit chimique à son domicile et un chat mort dans son frigo https://www.liberation.fr/societe/police-justice/a-paris-une-femme-meurt-empoisonnee-son-ex-compagnon-en-garde-a-vue-20230125_HNT7ICFLQFFMXO5LEUON6BPSMA/?outputType=amp",15,33,2,50
1587,1618530503812091905,2023-01-26 08:45:17,NemesisNemesi75,"Marvin J., son ex-compagnon duquel elle venait de se séparer, avait demandé à Chloé de se convertir à l’islam et avait distillé en elle l’idée que le Coran autorise un homme à frapper sa femme https://www.leparisien.fr/faits-divers/tentative-de-feminicide-appelez-le-17-et-revenez-demain-comment-chloe-a-ete-abandonnee-a-son-sort-26-01-2023-FNS42754IFE4TKBAI4TNL36FUA.php",17,45,2,64
1588,1618530501626855424,2023-01-26 08:45:17,NemesisNemesi75,"Le 13 décembre, Chloé qui avait été éconduite par le commissariat où elle voulait porter plainte (et où des policiers avaient pourtant été témoins d’une altercation du couple) subissait 2 heures plus tard une tentative d’assassinat de la part de Marvin, son ex-compagnon.",18,84,1,103
1589,1618527313909678080,2023-01-26 08:32:37,NemesisNemesi75,Un livreur d’Ikea interpellé et suspecté d'avoir commis une agression sexuelle sur une cliente. Il avait obtenu l'adresse de la victime grâce à son travail. https://www.bfmtv.com/amp/paris/yvelines-un-livreur-ikea-suspecte-d-agression-sexuelle-sur-une-cliente-interpelle_AN-202301250410.html,11,22,0,33
1590,1618526108479258624,2023-01-26 08:27:49,NemesisNemesi75,"Le procès de Maxime Mafioly s'est ouvert à Cahors. Il est jugé pour le viol et les violences commises sur Mme Antoinette Latrémolière, une dame âgée de 83 ans. https://actu.fr/occitanie/cahors_46042/cours-d-assises-du-lot-age-de-25-ans-il-est-accuse-du-viol-d-une-dame-de-83-ans_56886435.html",9,24,1,34
1591,1618284156471095296,2023-01-25 16:26:23,NemesisNemesi75,"Une jeune femme a été poignardée au sein de l’université Paris-Cité, boulevard Saint-Germain. Son pronostic vital est engagé. Un homme a été interpellé. https://amp.lepoint.fr/2506215",20,35,1,56
1592,1618211613496201217,2023-01-25 11:38:08,NemesisNemesi75,"À Montpellier, un jeune homme a été roué de coups après être intervenu pour stopper l’agression d’une jeune femme. Les agresseurs  âgés de 15 et 16 ans, ont été interpellés par la suite. et ont reconnu les faits. https://www.midilibre.fr/2023/01/25/montpellier-un-jeune-lynche-dans-le-tramway-10948647.php",22,53,2,77
1593,1617963034751950848,2023-01-24 19:10:22,NemesisNemesi75,"C’était aussi vos clients ? « DavidMETAXAS: Les personnes interpellées au moment du verdict prononcé dans l’affaire Axelle Dorier évitent la prison ferme et écopent de peines d’emprisonnement avec sursis 

https://france3-regions.francetvinfo.fr/auvergne-rhone-alpes/rhone/lyon/affaire-axelle-dorier-le-point-sur-les-quelques-minutes-de-chaos-qui-ont-suivi-le-verdict-2699370.html — https://twitter.com/davidmetaxas/status/1617595610235797515 »",8,43,1,52
1594,1617961807985152001,2023-01-24 19:05:29,NemesisNemesi75,"Arques: une mère de famille égorgée à son domicile, son compagnon actuel est suspecté d’assassinat. Après une cavale de plusieurs jours, il a été interpellé et écroué. https://www.lavoixdunord.fr/1282639/article/2023-01-24/arques-une-mere-de-famille-tuee-son-domicile-son-ex-compagnon-suspecte",15,26,1,42
1595,1617944963333132288,2023-01-24 17:58:33,NemesisNemesi75,"Un migrant clandestin condamné à 18 mois de prison seulement pour des vols commis dans une soixantaine de logements Nantais. Lors d’une intrusion, il a également commis une agression sexuelle. https://www.ouest-france.fr/pays-de-la-loire/trois-ans-de-prison-requis-pour-une-serie-de-vols-sans-effraction-et-d-agressions-0332e61e-9730-11ed-8634-d0413f2d7cce",25,49,3,77
1596,1617840790625226754,2023-01-24 11:04:37,NemesisNemesi75,"Femme retrouvée morte ce dimanche après-midi à Pont-Péan au sud de Rennes : son compagnon a avoué le meurtre de sa compagne à l'aide d'une rallonge électrique. 
https://www.francebleu.fr/amp/infos/faits-divers-justice/meurtre-a-pont-pean-le-conjoint-avoue-avoir-tue-sa-femme-avec-une-rallonge-electrique-5953970",7,12,0,19
1597,1617837980877729792,2023-01-24 10:53:27,NemesisNemesi75,Les enfants dont les parents leur ont inculqué la haine de la France et des « mécréants » seront donc bientôt dans nos rues… https://www.leparisien.fr/amp/faits-divers/une-quinzaine-de-djihadistes-francaises-rapatriees-de-syrie-ce-mardi-24-01-2023-L63CACS2BNHBPJEK3SP547WO24.php,99,205,15,319
1598,1617836478243180544,2023-01-24 10:47:29,NemesisNemesi75,"Le verdict est attendu mercredi soir.

https://amp.lepoint.fr/2505612",3,17,0,20
1599,1617836474514427907,2023-01-24 10:47:28,NemesisNemesi75,"Le Youtubeur « coach en séduction » et «expert en masculinité» Mickaël Philétas, est jugé depuis mardi pour l'assassinat de son ex-compagne Mélanie Ghione. Il comparaît aussi pour double tentative de meurtre sur la petite sœur de la victime et son compagnon. https://twitter.com/NemesisNemesi75/status/1617836474514427907/photo/1",57,122,10,189
1600,1617835333625995267,2023-01-24 10:42:56,NemesisNemesi75,"🛑Procès #AxelleDorier : en France, on peut créer une émeute et tabasser jusqu’à faire perdre 4 dents à des policiers si la peine prononcée pour notre ami ne nous convient pas. 3 amis du condamné Youcef Tebbal condamné à du sursis seulement. https://www.lefigaro.fr/lyon/lyon-trois-hommes-condamnes-pour-les-violences-survenues-a-la-fin-de-proces-axelle-dorier-20230123",61,91,4,156
1601,1617490896349437952,2023-01-23 11:54:15,NemesisNemesi75,https://www.radiofrance.fr/franceinter/barometre-du-sexisme-2023-la-situation-est-alarmante-estime-le-haut-conseil-a-l-egalite-2356270,3,10,1,14
1602,1617490894256488448,2023-01-23 11:54:15,NemesisNemesi75,"- Neuf femmes sur dix adoptent des ""conduites d'évitement"" pour éviter des actes sexistes

-93% de la population constate des inégalités de traitement entre hommes et femmes

et certains voudraient nous faire croire qu’on a plus besoin du féminisme ?",8,23,5,36
1603,1617490891555639297,2023-01-23 11:54:14,NemesisNemesi75,"Les résultats du deuxième ""Baromètre Sexisme"" mené par l'Institut Viavoice pour le Haut Conseil à l'Égalité est accablant. On y apprend entre autres que :

- 15% des femmes ont déjà subi des coups portés par leur partenaire ou ex-partenaire",17,58,6,81
1604,1617471118847377409,2023-01-23 10:35:40,NemesisNemesi75,Monsieur @PascalPraud remet à sa place @DavidMETAXAS qui fanfaronne sur le fait que son client pourra éventuellement sortir sous bracelet d’ici un an. https://twitter.com/NemesisNemesi75/status/1617471118847377409/video/1,111,276,25,412
1605,1617469160115826688,2023-01-23 10:27:53,NemesisNemesi75,"Affaire #AxelleDorier : puisque Youcef Tebbal et son avocat @DavidMETAXAS ne font pas appel, le parquet DOIT le faire. Et puisque les condamnés bénéficient de réductions et d’aménagements de peine, alors les juges doivent systématiquement prononcer la peine MAXIMALE.",54,176,4,234
1606,1617458017447854085,2023-01-23 09:43:36,NemesisNemesi75,"Sur @CNEWS, @DavidMETAXAS l’avocat de Youcef Tebbal, responsable de la mort de #AxelleDorier annonce que son client pourra bénéficier d’une mise sous bracelet électronique d’ici 1 an. C’est l’insupportable preuve du laxisme judiciaire qui règne. La preuve de trop.",343,727,27,1097
1607,1617445225382772736,2023-01-23 08:52:47,NemesisNemesi75,https://www.francebleu.fr/amp/infos/faits-divers-justice/pont-pean-un-homme-arrete-apres-la-decouverte-du-corps-de-sa-conjointe-6897171,0,6,0,6
1608,1617445223826612227,2023-01-23 08:52:46,NemesisNemesi75,"À Pont Péan, au sud de Rennes, le corps d'une femme, âgée de 47 ans, a été retrouvé dans son domicile, recouvert de lésions. Il y a un an, la victime s’était présentée à la gendarmerie affirmant avoir peur de son mari lorsqu’il est en colère. Il a été placé en garde à vue.",16,56,1,73
1609,1617443940193501184,2023-01-23 08:47:40,NemesisNemesi75,"Saint-Brieuc : dimanche 22 janvier, un homme de 24 ans tue sa fille et sa compagne avant de se suicider. Il a aussi tiré sur sa belle-mère avant de retourner l’arme contre lui. https://www.ouest-france.fr/bretagne/saint-brieuc-22000/saint-brieuc-un-pere-tue-sa-fille-et-sa-compagne-avant-de-se-suicider-77690eae-9a8d-11ed-a55d-99abe492fe96",10,35,1,46
1610,1617442635551244289,2023-01-23 08:42:29,NemesisNemesi75,"Il y a seize mois, le 10 août 2021, une mère et sa fille ont été poignardées à mort dans leur appartement à Saint-Ouen-l’Aumône (Val-d'Oise). Un Sri-Lankais de 27 ans a été mis en examen et écroué ce mercredi, soupçonné d'être l'auteur de ce crime https://actu17.fr/enquetes/une-mere-et-sa-fille-poignardees-a-mort-a-saint-ouen-laumone-un-suspect-ecroue.html?fbclid=PAAaYmngdiJEG3VQvOeu5Uvi2Aeo_V4O1-wYObOJC7niDcqA-P0-rWzi0AOpI",15,36,0,51
1611,1617179001729974273,2023-01-22 15:14:54,NemesisNemesi75,"Nous avons quelques Aveyronnaises parmi nos militantes à Némésis. Mais en avons-nous parmi nos abonnés ?

 #identitéfrançaise #francaise #francaiseetfiere https://twitter.com/NemesisNemesi75/status/1617179001729974273/photo/1",13,68,3,84
1612,1616759899324821504,2023-01-21 11:29:32,NemesisNemesi75,"Parce que c’est tout ce que nous pouvons faire, nous étions présentes ce matin devant le Palais de l’injustice de Lyon. https://twitter.com/NemesisNemesi18/status/1616759899324821504/photo/1",154,487,13,654
1613,1616757909572194305,2023-01-21 11:21:38,NemesisNemesi75,Youcef Tebbal et son avocat Maitre Metaxas sont tellement satisfaits du verdict qu’ils ne vont même pas prendre la peine de faire appel. La honte. Comment ne pas comprendre la colère de Theo Dorier le frère d’Axelle ? https://twitter.com/NemesisNemesi18/status/1616757909572194305/video/1,180,438,29,647
1614,1616752572403957763,2023-01-21 11:00:25,NemesisNemesi75,"Avec un tel verdict, #AxelleDorier est tuée une seconde fois.",19,105,3,127
1615,1616752570906677252,2023-01-21 11:00:25,NemesisNemesi75,"Procès Axelle Dorier, le bilan : Étant donné que Youcef Tebbal a déjà fait 2 ans et demi de détention provisoire. Om bénéficiera d’aménagements et de réductions de peine. Youcef pourrait être dehors à l’été 2026, soit dans 3 ans et demi.

https://youtube.com/watch?v=4u8x2O7kEPQ&si=EnSIkaIECMiOmarE",85,190,6,281
1616,1616711148467884033,2023-01-21 08:15:49,NemesisNemesi75,"En Tunisie aussi l’ancien ministre Mabrouk Korchid s’inquiète d’un « grand remplacement ». Si les Tunisiens continuent d’émigrer, « les Africains vont venir se marier chez nous et nous remplacer », a-t-il expliqué. https://www.lemonde.fr/afrique/article/2023/01/17/en-tunisie-les-subsahariens-victimes-d-un-racisme-croissant_6158240_3212.html",17,46,2,65
1617,1616711146374848513,2023-01-21 08:15:48,NemesisNemesi75,La une de @marochebdo de ce mois de janvier. https://twitter.com/NemesisNemesi18/status/1616711146374848513/photo/1,53,152,9,214
1618,1616563576784789504,2023-01-20 22:29:25,NemesisNemesi75,"Ça ne réglerait pas tout mais nul doute que les femmes françaises seraient bien moins emmerdées dans la rue. « libe: Ramzy Bedia prépare un film où tous les Maghrébins quittent la France : «Sur les chaînes d’info, dès qu’il fait froid, c’est la faute des Arabes. Vous savez quoi, on va se barrer et on va voir, vu que c’est nous le problème, si ça va tout régler» : http://bit.ly/3Hhdt2j https://twitter.com/libe/status/1616453350572130305/photo/1 — https://twitter.com/libe/status/1616453350572130305 »",61,383,14,458
1619,1616534317974388751,2023-01-20 20:33:09,NemesisNemesi75,"Le meurtrier d’Axelle prend 12 ans seulement. Une peine ridicule quand on sait qu’il va faire appel et que dans la très grande majorité des cas en appel, l’accusé voit sa peine reduite. Ça plus les réductions et les aménagements de peine… nous sommes dévastées par ce verdict.",287,778,32,1097
1620,1616531791086583824,2023-01-20 20:23:07,NemesisNemesi75,"Verdict du procès Axelle Dorier : Le principal suspect est reconnu coupable de coups mortels avec arme et est condamné à 12 ans de réclusion criminelle. Le passager écope d'une peine de cinq ans, dont trois avec sursis.

https://www.bfmtv.com/amp/lyon/affaire-axelle-dorier-le-conducteur-de-la-voiture-condamne-a-12-ans-de-reclusion-criminelle_AN-202301200684.html",38,104,12,154
1621,1616506859405602816,2023-01-20 18:44:03,NemesisNemesi75,@WitoldSpyPoland Il fera appel dans tous les cas,0,0,1,1
1622,1616475140308467717,2023-01-20 16:38:00,NemesisNemesi75,"🛑Procès Axelle: La cour se retire pour délibérer. Le verdict est attendu dans plusieurs heures. Nous sommes de tout à cœur avec la famille d’Axelle et nous souhaitons qu’enfin, un juge mette la peine maximale. Que pour une fois dans ce pays on ne se moque pas des victimes.",42,214,7,263
1623,1616444370194165771,2023-01-20 14:35:44,NemesisNemesi75,"« Hier, ce fut l’apothéose des déclarations de déni absolu. Le transfert de responsabilité de la mort d’Axelle sur Clément. Si elle est morte, c’est de la faute de son petit copain. Mais comment peut-on tenir un propos pareil ? », questionne-t-il, à l’attention de Youcef Tebbal.",27,127,4,158
1624,1616444368537141249,2023-01-20 14:35:44,NemesisNemesi75,"🛑Procès Axelle Dorier : Maître Versini-Bullara, avocat des parties civiles, en conclusion de sa plaidoirie, déplore « l’insupportable culture du déni (…). « La présence de skinheads est une fantasmagorie totale (…) Il n’y a pas d’arme blanche, on le sait. »",66,214,3,283
1625,1616435198110875653,2023-01-20 13:59:17,NemesisNemesi75,"🛑Procès Axelle Dorier : Hier, l’accusé a avoué avoir voulu faucher avec sa voiture Clément, le petit ami d’Axelle. Il indique donc très clairement avoir voulu tuer quelqu’un intentionnellement : C’est un MEURTRE. #JusticePourAxelle https://twitter.com/NemesisNemesi18/status/1616435198110875653/photo/1",161,339,10,510
1626,1616426603499626498,2023-01-20 13:25:08,NemesisNemesi75,"Un prof qui se vante sur Twitter de traiter une étudiante ukrainienne de nazie. @toutancitron étant donné que tu dis ne pas être prof à l’Education nationale, où enseignes-tu que l’on vienne assister à tes cours ? Promis on t’attaquera pas sur ton physique. https://twitter.com/NemesisNemesi18/status/1616426603499626498/photo/1",20,133,11,164
1627,1616406944214061057,2023-01-20 12:07:01,NemesisNemesi75,🛑Procès Axelle Dorier : L’avocat général requiert 16 ans de réclusion criminelle contre le conducteur Youcef Tebbal. Verdict en fin de journée. https://twitter.com/NemesisNemesi18/status/1616406944214061057/photo/1,60,166,29,255
1628,1616132553454370869,2023-01-19 17:56:41,NemesisNemesi75,"Pour la femme qui a percuté le chien, une connaissance des accusés rencontrée sur Snapchat, la reponse est formelle : Youcef Tebbal aurait pu contourner Axelle. « noemieschulz: La réponse n'est pas très claire. Elle ne comprend pas bien la questions, dit oui, puis non. En revanche elle semble formelle ""oui la voiture aurait pu partir en contournant Axelle"". — https://twitter.com/noemieschulz/status/1615399286467854338 »",14,38,0,52
1629,1616131006536335362,2023-01-19 17:50:32,NemesisNemesi75,"@noemieschulz Bonjour @noemieschulz , concernant ce tweet, si nous comprenons bien, les accusés et leurs amies étaient dans un endroit interdit aux voitures ?",0,3,0,3
1630,1616069887910109185,2023-01-19 13:47:41,NemesisNemesi75,"@PenoCuenta @CordierAlice2 C’est assez clair pourtant, on aurait préféré que notre fils meure parce que ce qu’on vit depuis son arrestation c’est peut-être pire que ce que vit la famille d’Axelle. Comme d’habitude, toujours plus victimes que les victimes et les familles de victimes elles-mêmes.",9,123,1,133
1631,1616032323019091968,2023-01-19 11:18:24,NemesisNemesi75,@FreyjaCharlie On y arrive vu que l’avocat général fait planer le doute de l’agression raciste,9,100,5,114
1632,1616030004881797121,2023-01-19 11:09:12,NemesisNemesi75,"Mohamed Tebbal, le père de l’accusé explique : « On a vécu 36 mois peut-être pires que la famille d’Axelle. »(…). Pire que la perte de son propre enfant vraiment ? https://twitter.com/NemesisNemesi18/status/1616030004881797121/photo/1",346,843,122,1311
1633,1616023276597174273,2023-01-19 10:42:28,NemesisNemesi75,Il l’a carrément prévenue mais on veut nous faire croire à l’accident,9,89,1,99
1634,1616022434913857538,2023-01-19 10:39:07,NemesisNemesi75,"🛑 Procès Axelle Dorier : Invité à témoigner, l'un des amis du petit copain d'Axelle a assuré que Youcef Tebbal, principal accusé et conducteur du véhicule, avait déclaré : ""Si je ne peux pas vous frapper, je vais vous rouler dessus.""",122,292,10,424
1635,1616015402144002050,2023-01-19 10:11:10,NemesisNemesi75,Ta copine se fait littéralement rouler dessus mais c’est encore toi qui doit rendre des comptes et prouver que tu n’es pas raciste. Insupportable.,51,217,5,273
1636,1616010958932951040,2023-01-19 09:53:31,NemesisNemesi75,Procès Axelle Dorier : Le procureur demande au petit ami d’Axelle Dorier s’il est « skinhead » car il est ancien militaire et tatoué. Vous la sentez venir la circonstance atténuante pour agression raciste qui a mal tourné à cause des juges de gauche ? #justicepourAxelle https://twitter.com/NemesisNemesi18/status/1616010958932951040/photo/1,126,321,13,460
1637,1615993017994731520,2023-01-19 08:42:13,NemesisNemesi75,https://www.leprogres.fr/amp/faits-divers-justice/2023/01/18/affaire-axelle-dorier-suivez-la-deuxieme-journee-du-proces,7,25,2,34
1638,1615993016396967937,2023-01-19 08:42:13,NemesisNemesi75,"Le Dr Fabrizi, celui qui a procédé à l'autopsie d'Axelle Dorier le 21 juillet 2020, a expliqué avoir observé une multiplicité de lésions « exceptionnelle ». Il affirme que « la mort n’a pas été instantanée » et qu’elle aurait pu survivre si le véhicule s’était arrêté plus tôt.",45,141,8,194
1639,1615972150032367616,2023-01-19 07:19:18,NemesisNemesi75,https://www.sudouest.fr/gironde/talence/talence-un-adjoint-au-maire-poursuivi-pour-agression-sexuelle-13727483.amp.html,1,2,0,3
1640,1615972148417363968,2023-01-19 07:19:18,NemesisNemesi75,"Patrick Duart sera jugé devant le tribunal correctionnel de Bordeaux pour agressions sexuelles, vendredi 20 janvier. Les faits reprochés à l’élu ont eu lieu à son domicile en novembre 2019 emai 2020, où une auxiliaire de vie et une infirmière intervenaient auprès de son épouse.",11,25,1,37
1641,1615970928239808513,2023-01-19 07:14:27,NemesisNemesi75,"Luc Boisson, 74 ans, qui fut pendant vingt ans maire de Saint-Maximin, près d'Uzès, a été condamné le 25 novembre 2022 à 12 ans de réclusion par la cour d'assises du Gard pour avoir violé l'une de ses employées municipales. https://www.midilibre.fr/2023/01/18/gard-condamne-a-douze-ans-pour-viol-lex-maire-de-saint-maximin-demande-sa-liberation-avant-son-proces-en-appel-10934510.php https://twitter.com/NemesisNemesi18/status/1615970928239808513/photo/1",14,23,1,38
1642,1615970543726956544,2023-01-19 07:12:55,NemesisNemesi75,Pyrénées-Atlantiques : un homme de 30 ans mis en examen pour le viol d'une octogénaire https://www.francetvinfo.fr/societe/justice/pyrenees-atlantiques-un-homme-de-30-ans-mis-en-examen-pour-le-viol-d-une-octogenaire_5608604.html,9,12,0,21
1643,1615968055330476033,2023-01-19 07:03:02,NemesisNemesi75,https://france3-regions.francetvinfo.fr/occitanie/haute-garonne/toulouse/justice-un-etudiant-en-medecine-et-fils-de-chirurgien-mis-en-cause-pour-viol-apres-deux-plaintes-deposees-a-toulouse-2696466.html,3,3,0,6
1644,1615701081513758720,2023-01-18 13:22:10,NemesisNemesi75,"La Française sœur André, doyenne de l’humanité, est morte à 118 ans. Elle est, selon Laurent Toussaint, spécialiste de la longévité extrême en France, la quatrième personne à avoir vécu le plus longtemps dans l’histoire de l’humanité. https://www.lemonde.fr/societe/article/2023/01/17/la-doyenne-de-l-humanite-la-francaise-s-ur-andre-est-morte-a-118-ans_6158261_3224.html",5,52,1,58
1645,1615407121222492160,2023-01-17 17:54:05,NemesisNemesi75,Nous réclamons la peine maximale et aucune clémence pour le conducteur qui roulait d’ailleurs sans permis depuis des mois. Nous réclamons la justice pour celle qui aurait pu être notre soeur. https://twitter.com/NemesisNemesi18/status/1615407121222492160/photo/1,9,39,0,48
1646,1615407114402275328,2023-01-17 17:54:03,NemesisNemesi75,"Nous apportons une nouvelle fois notre soutien aux parents et aux frères d’Axelle.

Leur fille et soeur a fait les frais de l’ensauvagement de notre société, et comme souvent, elle est le fait du même genre d’individus. #JusticePourAxelle https://twitter.com/NemesisNemesi18/status/1615407114402275328/photo/1",51,178,2,231
1647,1615372071911002114,2023-01-17 15:34:48,NemesisNemesi75,https://www.leparisien.fr/faits-divers/il-avait-renverse-une-femme-avant-de-la-trainer-sur-plus-de-800-metres-le-conducteur-juge-aux-assises-16-01-2023-VUDAHVWYGNEV7LLNV7ALM3GQBI.php,8,18,0,26
1648,1615372068744302593,2023-01-17 15:34:48,NemesisNemesi75,"Aujourd’hui s’ouvre le procès de Youcef Tebbal, le meurtrier d’Axelle Dorier. Il est poursuivi pour violence avec arme ayant entraîné la mort ""sans intention de la donner"". Quand on fonce volontairement avec sa Golf sur une jeune femme, on pense vraiment qu’on ne va pas la tuer? https://twitter.com/NemesisNemesi18/status/1615372068744302593/photo/1",109,259,7,375
1649,1615368165772627968,2023-01-17 15:19:17,NemesisNemesi75,"Une femme de 78 ans violée à Lille à son domicile le 15 janvier par Mohamed C., un migrant sous OQTF https://amp.lefigaro.fr/faits-divers/lille-un-individu-vise-par-une-oqtf-suspecte-du-viol-d-une-femme-de-78-ans-20230117",14,15,2,31
1650,1615338627109732354,2023-01-17 13:21:54,NemesisNemesi75,Nos provençales à l’honneur aujourd’hui. Connaissez-vous d’autres femmes provençales illustres ? https://m.youtube.com/watch?v=xj0EvUkWfLU,6,12,1,19
1651,1615295965778579457,2023-01-17 10:32:23,NemesisNemesi75,"Une enquête ouverte contre Noël Le Graët pour harcèlement moral et sexuel. « Il m’a dit en tête à tête, dans son appartement, très clairement, que si je voulais qu’il m’aide, il fallait passer à la casserole » explique Sonia Souid, agente de sportifs. https://www.liberation.fr/sports/football/outrage-sexiste-noel-le-graet-vise-par-une-enquete-pour-harcelement-moral-et-sexuel-20230117_2MHAO7BXQJELPIQBAHHFXSGWNM/?outputType=amp",6,15,0,21
1652,1615273167596953605,2023-01-17 09:01:48,NemesisNemesi75,"Dans une interview menée par le Disrupteur, notre présidente @CordierAlice2 se livre sur ce qui l’a menée au feminisme et au militantisme. La vidéo à voir en entier ici : https://youtube.com/watch?v=Dudnp-_a378&si=EnSIkaIECMiOmarE https://twitter.com/NemesisNemesi18/status/1615273167596953605/video/1",8,29,1,38
1653,1614939970833096705,2023-01-16 10:57:47,NemesisNemesi75,https://actu17.fr/amp/faits-divers/le-havre-deux-femmes-violees-le-meme-jour-deux-hommes-mis-en-examen-et-ecroues.html,2,9,0,11
1654,1614939969394561024,2023-01-16 10:57:47,NemesisNemesi75,"Au Havre, deux femmes violées le même jour. L’une par un un ressortissant du Sierra Leone déjà connu des services de police et en situation régulière sur le territoire la seconde, une septuagénaire, par un homme âgé de 25 ans, déjà connu des services de police.",67,128,4,199
1655,1614711673029365760,2023-01-15 19:50:37,NemesisNemesi75,"Hier à Strasbourg, un Kosovar a tenté de poignardé des passants dont ine mère de famille accompagnée de ses deux enfants aux cris de « Allah Akbar ». Il a été neutralisé par un policier en civil. https://www.lefigaro.fr/faits-divers/strasbourg-un-homme-arme-d-un-couteau-s-attaque-a-des-passants-avant-d-etre-maitrise-par-un-policier-hors-service-20230115",29,47,3,79
1656,1614537009548197891,2023-01-15 08:16:34,NemesisNemesi75,"Tout citoyen français attaché aux libertés devrait avoir honte que son pays n’arrive à expulser réellement qu’un seul islamiste tous les 100 ans surtout. « FeizaBM: Tout citoyen français attaché aux libertés devrait avoir honte que son pays ait conduit à une telle situation écoeurante, islamophobe, injuste et cynique. 
Une famille déchirée gratuitement et sacrifiée pour des considérations purement politiques… 
La honte est immense. — https://twitter.com/feizabm/status/1614000441221869568 »",22,115,0,137
1657,1613882862402420737,2023-01-13 12:57:13,NemesisNemesi75,"Saint-Nazaire : Christophe, un policier en repos arrête le violeur présumé d’une jeune fille de 13 ans grâce à une photo dans sa poche. L’homme interpellé avait un couteau de cuisine dans son sweat. Il disait s’en servir pour «pique-niquer». https://actuforcesdelordre.fr/2023/01/12/saint-nazaire-un-policier-en-repos-arrete-le-violeur-presume-dune-jeune-fille-de-13-ans-grace-a-une-photo-dans-sa-poche/#lcuit4t4f39zyr2bhv",17,50,3,70
1658,1613875080202973185,2023-01-13 12:26:18,NemesisNemesi75,"Une femme de 67 ans a été violemment agressée à coups de couteau lundi 9 janvier 2023, à Élancourt. https://actu.fr/ile-de-france/elancourt_78208/agression-au-couteau-a-elancourt-une-femme-de-67-ans-gravement-blessee_56572894.html",16,37,1,54
1659,1613622234915938305,2023-01-12 19:41:35,NemesisNemesi75,"2/2 Alors, laissons parler les concernées : nous, nous en portons et oui dans certains quartiers on ne peut pas se balader ainsi.",73,468,12,553
1660,1613622233238315009,2023-01-12 19:41:34,NemesisNemesi75,"1/2 Sur @TPMP à l’affirmation de @DamienRieu comme quoi dans certains quartiers les femmes ne peuvent plus se balader en jupe, nous avons 3 hommes et une femme voilée (donc à priori qui ne portent pas de jupes) qui nient et se moquent.",286,1169,19,1474
1661,1613613635473133568,2023-01-12 19:07:24,NemesisNemesi75,Incroyable qu’on se pose ce genre de questions quand même. « TPMP: Diffusion de photos de prière : Le compte du militant d'extrême droite Damien Rieu doit-il être suspendu ? #TPMP — https://twitter.com/tpmp/status/1613610900383989776 »,14,76,3,93
1662,1613580671305543680,2023-01-12 16:56:25,NemesisNemesi75,@FrDesouche Tout à fait vrai. D’autant plus que ces chaînes ne sont jamais rappelées à l’ordre par le CSA (Arcom),0,8,1,9
1663,1613501331427262560,2023-01-12 11:41:09,NemesisNemesi75,Nous sommes ravies d’apprendre que @ArnaultRaphael soutient et admire « les peuples qui défendent ardemment leur identité » 🙃 : https://twitter.com/NemesisNemesi18/status/1613501331427262560/video/1,30,154,4,188
1664,1613232396135981064,2023-01-11 17:52:30,NemesisNemesi75,L’attaque gare du Nord de ce matin qui a fait 6 blessés est le fait d’un migrant libyen sous OQTF. https://www.huffingtonpost.fr/faits-divers/article/attaque-a-gare-du-nord-le-suspect-est-un-libyen-vise-par-une-oqtf_212630.html,14,35,2,51
1665,1613172172230385666,2023-01-11 13:53:11,NemesisNemesi75,https://www.valeursactuelles.com/clubvaleurs/faits-divers/info-va-un-violeur-recidiviste-interpelle-pour-le-viol-dune-jeune-femme-de-28-ans-a-metz,15,34,2,51
1666,1613172170695352320,2023-01-11 13:53:11,NemesisNemesi75,"Farid L., déjà condamné à 22 ans de prison au total pour deux viols commis en 2002 et 2009, a été mis en examen et écroué ce vendredi 6 janvier pour un nouveau viol commis le 4 décembre dernier sur une femme. Le viol a été filmé par l’auteur avec le téléphone de la victime.",342,582,29,953
1667,1613171134140239872,2023-01-11 13:49:04,NemesisNemesi75,"Allemagne: une enseignante de 55 ans poignardée à mort par Sinan B., un élève de 17 ans issu de l’immigration. https://www.rtl.de/cms/bluttat-in-ibbenbueren-schueler-trauern-um-ihre-lehrerin-frau-k-war-die-beste-von-der-ganzen-schule-15024695.html",22,28,1,51
1668,1613170063078563840,2023-01-11 13:44:48,NemesisNemesi75,https://www.nicematin.com/amp/faits-divers/une-mere-et-son-bebe-en-poussette-renverses-un-fuyard-a-scooter-interpelle-819639,1,7,0,8
1669,1613170061543342081,2023-01-11 13:44:48,NemesisNemesi75,"À Nice, une femme de 31 ans avec une poussette ont été renversés sur un passage protégé par le pilote d'un scooter. La mère a été sérieusement blessée. L'auteur de a pris la fuite mais il a été rapidement été interpellé par la police. Il est actuellement en garde à vue.",37,135,5,177
1670,1613126969616367616,2023-01-11 10:53:34,NemesisNemesi75,Il ne faut pas attendre que de telles choses se produisent pour enfin expulser tous les illégaux de notre territoire… #justicepourLola            https://www.leparisien.fr/amp/faits-divers/meurtre-de-lola-la-soeur-de-la-suspecte-dahbia-b-expulsee-en-algerie-10-01-2023-KWWI3ULYFBGJBCFG3TXDANIQL4.php,26,52,0,78
1671,1613114959537250305,2023-01-11 10:05:51,NemesisNemesi75,"Et parce que toujours plus, Syndicat @desdetenus s’est aussi fait passer pour l’assistant personnel de Bernard Arnault ou encore du roi de Thaïlande. Mais où va-t-il s’arrêter ? 😂",6,46,0,52
1672,1613113965567168513,2023-01-11 10:01:54,NemesisNemesi75,… a fait de la prison pour s’être fait passer pour le neveu de Brigitte Macron afin d’obtenir des prestations de luxe 😂 t’en as d’autres des comme ça @desdetenus ? https://www.leparisien.fr/faits-divers/le-faux-neveu-de-brigitte-macron-condamne-a-un-an-de-prison-ferme-27-10-2021-KZGBQEQORBCHRHBC3T4ZEOCIFY.php,11,60,2,73
1673,1613113962769387521,2023-01-11 10:01:53,NemesisNemesi75,"Nous apprenons avec hilarité suite à l’excellent thread de @LouiseOdessa que le célèbre compte Twitter « Syndicat» @desdetenus est tenu par @coryleguen , un énorme mythomane qui ment sur son âge, se fait passer pour journaliste sur BFM pour draguer des femmes et… « collnemesis: « Tous mineurs ». Source : Evian. 
Le culot de sortir un si gros mensonge alors qu’ils n’ont justement pas été reconnus comme mineurs par l’Etat. Le même État qui arrive pourtant à reconnaître des mineurs des mecs qui ont au moins 25 ans et sans tests osseux… — https://twitter.com/collnemesis/status/1599862843330859008 »",63,151,4,218
1674,1612487412264886272,2023-01-09 16:32:12,NemesisNemesi75,"Nous souhaitons un prompt rétablissement à Caroline Margeridon qui a reçu plusieurs coups au visage avant d’être dépouillée par deux malfaiteurs. Nous espérons qu’ils seront vite retrouvés. « le_Parisien: 🔴Caroline Margeridon, l’antiquaire d’«Affaire conclue», agressée et dépouillée sur un parking

➡️ https://l.leparisien.fr/iF13 https://twitter.com/le_Parisien/status/1612418489083363328/photo/1 — https://twitter.com/le_parisien/status/1612418489083363328 »",25,86,3,114
1675,1612441461277999106,2023-01-09 13:29:36,NemesisNemesi75,1 an de prison ferme et une interdiction du territoire français pendant 10 ans seulement pour un migrant qui avait agressé une réceptionniste d’hôtel à Deauville en novembre dernier. https://www.ouest-france.fr/normandie/deauville-14800/il-agresse-sexuellement-une-receptionniste-d-hotel-avant-de-s-en-prendre-aux-policiers-2059c626-8eb7-11ed-806e-478dc5e333ee,16,35,0,51
1676,1612138859978018823,2023-01-08 17:27:10,NemesisNemesi75,https://www.leparisien.fr/amp/seine-saint-denis-93/seine-saint-denis-un-homme-arrete-apres-le-deces-de-son-epouse-dans-le-var-08-01-2023-YBSS5OFWUNHNVNWZBQXDLMI3RM.php,3,10,0,13
1677,1612138857591365632,2023-01-08 17:27:10,NemesisNemesi75,"Après 2 semaines de fuite, l’homme, un Tunisien de 39 ans, a été arrêté par la BRI alors qu’il était dans un appartement de Pierrefitte-sur-Seine. Il a accueilli les policiers en les menaçant avec une arme de poing et en criant Allah akbar. Les enfants sont toujours introuvables. « NemesisNemesi75: Le conjoint de Molka Hadaji, la femme dont le corps a été découvert la nuit de Noël à Saint-Raphaël, a été localisé au nord de Paris. Armé, il a été blessé par des tirs de police. On reste sans nouvelles des enfants du couple. https://www.varmatin.com/amp/faits-divers/meurtre-dune-femme-a-saint-raphael-son-conjoint-retrouve-en-region-parisienne-819291 — https://twitter.com/nemesisnemesi75/status/1612043740532580353 »",41,70,3,114
1678,1612043740532580353,2023-01-08 11:09:12,NemesisNemesi75,"Le conjoint de Molka Hadaji, la femme dont le corps a été découvert la nuit de Noël à Saint-Raphaël, a été localisé au nord de Paris. Armé, il a été blessé par des tirs de police. On reste sans nouvelles des enfants du couple. https://www.varmatin.com/amp/faits-divers/meurtre-dune-femme-a-saint-raphael-son-conjoint-retrouve-en-region-parisienne-819291",30,88,1,119
1679,1611808646538608640,2023-01-07 19:35:01,NemesisNemesi75,Un Algérien en situation irrégulière interpellé pour avoir tenté d'immoler sa compagne par le feu à Marseille. https://actu17.fr/amp/faits-divers/marseille-un-homme-interpelle-pour-avoir-tente-dimmoler-sa-compagne-par-le-feu.html,84,189,4,277
1680,1611662860240752640,2023-01-07 09:55:43,NemesisNemesi75,https://www.cnews.fr/faits-divers/2023-01-06/paris-vise-par-une-oqtf-un-migrant-algerien-agresse-sexuellement-une,6,24,3,33
1681,1611662858978295810,2023-01-07 09:55:43,NemesisNemesi75,"Un Algérien en situation irrégulière a agressé sexuellement une étudiante de 19 ans dans un bus, le 28 novembre dernier à Paris. L'homme a été condamné par la justice à une peine de quatre mois de prison ferme et une interdiction du territoire français pour dix ans.",119,319,16,454
1682,1611386944151232512,2023-01-06 15:39:20,NemesisNemesi75,Une jeune femme de 24 ans poignardée dans le Lidl du Luc dans le Var par un un mineur non accompagné. La victime est dans un état grave. https://www.varmatin.com/faits-divers/une-jeune-femme-de-24-ans-poignardee-dans-le-lidl-du-luc-819052,67,83,8,158
1683,1611019501700632576,2023-01-05 15:19:15,NemesisNemesi75,Soutien aux organisateurs de la marche @ParisFierte.,20,124,1,145
1684,1611019499964080129,2023-01-05 15:19:14,NemesisNemesi75,Sainte Geneviève incarne tout ce que @GDarmanin ne sera jamais et ne sait pas faire : détourner les barbares de Paris. On comprend que l’idée d’une marche en son honneur lui déplaise mais pas qu’il fasse interdire cette marche pacifique qui n’a jamais posé aucun problème. https://twitter.com/NemesisNemesi18/status/1611019499964080129/photo/1,388,873,20,1281
1685,1610945215421972482,2023-01-05 10:24:03,NemesisNemesi75,"Yannick F.D., un ivoirien déjà condamné à seulement 30 mois de prison pour avoir vitriolé et tué un homme en août dernier, viole une étudiante de 1ère année en bioingénieur le 28 décembre sur un campus universitaire à Bruxelles. https://www.sudinfo.be/id597030/article/2023-01-05/lhorreur-bruxelles-sur-le-campus-de-lulb-le-parcours-terrifiant-de-yannick-fd-le https://twitter.com/NemesisNemesi18/status/1610945215421972482/photo/1",846,773,79,1698
1686,1610934209706692610,2023-01-05 09:40:19,NemesisNemesi75,"Huluf Kindeya Gebremariam, Seare Measho Redae, Haileab Ghebre Weldemichael, et Mihretab Haile Gebrehiwt, 4 migrants érythréens condamnés pour le viol avec violences d’une femme de 40 ans en Suède. Aucun ne sera expulsé. https://twitter.com/NemesisNemesi18/status/1610934209706692610/photo/1",113,158,13,284
1687,1610492076751474688,2023-01-04 04:23:27,NemesisNemesi75,"Source : http://ville-data.com, qui réunit les données ouvertes disponibles.",7,28,0,35
1688,1610492074704396290,2023-01-04 04:23:26,NemesisNemesi75,.@BertrandKern pouvez-vous œuvrer concrètement pour les femmes de votre ville où n’êtes-vous capables que de mesurettes risibles et inefficaces ?,15,112,1,128
1689,1610492071584092161,2023-01-04 04:23:26,NemesisNemesi75,".@BertrandKern, maire de la @VilledePantin, ce n’est pas en renommant la ville que vous effacerez le fait que les plaintes pour violences sexuelles sont en hausse de 36 % dans votre ville entre 2020 et 2021. https://twitter.com/NemesisNemesi18/status/1610492071584092161/photo/1",150,376,16,542
1690,1610483208252002304,2023-01-04 03:48:12,NemesisNemesi75,"Quand nous on fait une affiche avec une blonde qui se fait courser par un type noir et un type du moyen orient, notre asso se prend immédiatement un procès par @SOS_Racisme mais @SYTRALmobilites qui ne met que des blancs dans le rôle des harceleurs ne fera broncher aucune asso… « SYTRALmobilites: 🟣Nouvelle campagne contre le harcèlement sexiste, signée @Diglee, mettant en scène des victimes, témoins et agresseurs dans les transports en commun, ainsi que des 🔊 annonces sonores reprenant les messages clés de la campagne. https://twitter.com/SYTRAL_RHONE/status/1463791997853089793/photo/1 — https://twitter.com/sytralmobilites/status/1463791997853089793 »",325,881,36,1242
1691,1609895099898396675,2023-01-02 12:51:16,NemesisNemesi75,"Le soir du réveillon à Toulouse, un homme de 22 ans a été interpellé après avoir tenté de violer une femme en pleine rue. Heureusement, un passant a entendu la femme crier et a donné des coups de poing à l’homme, qui était déjà à moitié nu. https://actu.fr/occitanie/toulouse_31555/nuit-du-reveillon-a-toulouse-ivre-un-jeune-homme-tente-de-violer-une-femme-mais-il-tombe-sur-un-os_56296815.html",77,172,7,256
1692,1609893700540239875,2023-01-02 12:45:43,NemesisNemesi75,"Val-de-Marne : 9 suspects arrêtés le 13 décembre dernier pour le viol collectif d’une jeune femme de 19 ans en mars 2020 dans la cité des Mordac. La victime pourrait être stérile puisque ce jour-là, elle a contracté une maladie sexuellement transmissible. https://fr.news.yahoo.com/val-de-marne-neuf-suspects-arretes-viol-collectif-jeune-niortaise-112827547.html?guce_referrer=aHR0cHM6Ly93d3cuZ29vZ2xlLmZyLw&guce_referrer_sig=AQAAAHBfPvUao_XHmS4MKw2nSdk77Af6d0yGRUtkTA0W2E6HpUahHiMBgQX21xaR3HLhpp9lk6MUm5d5iZV7gMajr8l3pOEqHOP41xnFmOzaVFmsoau-P3hQqJQlu7MDe_LTbJTkADwN3ZAJPaF-wBHABqz_lQvYo3GiV8dkUkp1kdrh",215,248,27,490
1693,1609615302634913795,2023-01-01 18:19:28,NemesisNemesi75,Nous apprenons à l’instant que le suspect est un afghan : https://amp.lefigaro.fr/faits-divers/reims-une-joggeuse-poignardee-un-suspect-afghan-interpelle-20230101 « NemesisNemesi75: L’année 2022 s’est terminée à Reims par une agression au couteau contre une joggeuse par un homme d’une vingtaine d’années d’origine étrangère. https://www.lunion.fr/id441982/article/2022-12-31/reims-une-joggeuse-agressee-au-couteau?utm_medium=Social&utm_source=Twitter#lcd2ih90q9jwt6apeld — https://twitter.com/nemesisnemesi75/status/1609455993649524737 »,35,89,4,128
1694,1609455993649524737,2023-01-01 07:46:25,NemesisNemesi75,L’année 2022 s’est terminée à Reims par une agression au couteau contre une joggeuse par un homme d’une vingtaine d’années d’origine étrangère. https://www.lunion.fr/id441982/article/2022-12-31/reims-une-joggeuse-agressee-au-couteau?utm_medium=Social&utm_source=Twitter#lcd2ih90q9jwt6apeld,56,90,2,148
